INN_CT,BAT_HOME_ID,OUTS_CT,RUNNERS,HOME_AWAY,HOME_LOSES,GAMES,HOME_WINS,HOME_WIN_PROB,AWAY_WIN_PROB
1,0,0,0,-8,1,1,0,0,100
1,0,0,0,-7,1,1,0,0,100
1,0,0,0,-6,10,10,0,0,100
1,0,0,0,-5,26,30,4,13.3,86.7
1,0,0,0,-4,137,164,27,16.5,83.5
1,0,0,0,-3,272,363,91,25.1,74.9
1,0,0,0,-2,394,563,169,30,70
1,0,0,0,-1,1097,1939,842,43.4,56.6
1,0,0,0,0,60698,129846,69148,53.3,46.7
1,0,0,0,2,1,1,0,0,100
1,0,0,1,-7,2,2,0,0,100
1,0,0,1,-6,3,4,1,25,75
1,0,0,1,-5,15,16,1,6.2,93.8
1,0,0,1,-4,55,66,11,16.7,83.3
1,0,0,1,-3,111,150,39,26,74
1,0,0,1,-2,276,387,111,28.7,71.3
1,0,0,1,-1,815,1378,563,40.9,59.1
1,0,0,1,0,17422,34087,16665,48.9,51.1
1,0,0,1,2,1,1,0,0,100
1,0,0,2,-7,1,1,0,0,100
1,0,0,2,-6,9,9,0,0,100
1,0,0,2,-5,13,13,0,0,100
1,0,0,2,-4,37,39,2,5.1,94.9
1,0,0,2,-3,97,125,28,22.4,77.6
1,0,0,2,-2,260,359,99,27.6,72.4
1,0,0,2,-1,700,1124,424,37.7,62.3
1,0,0,2,0,5496,10244,4748,46.3,53.7
1,0,0,12,-6,6,6,0,0,100
1,0,0,12,-5,9,9,0,0,100
1,0,0,12,-4,34,38,4,10.5,89.5
1,0,0,12,-3,82,107,25,23.4,76.6
1,0,0,12,-2,277,360,83,23.1,76.9
1,0,0,12,-1,677,1019,342,33.6,66.4
1,0,0,12,0,3686,6439,2753,42.8,57.2
1,0,0,3,-7,1,1,0,0,100
1,0,0,3,-6,2,3,1,33.3,66.7
1,0,0,3,-5,5,6,1,16.7,83.3
1,0,0,3,-4,13,15,2,13.3,86.7
1,0,0,3,-3,27,35,8,22.9,77.1
1,0,0,3,-2,86,120,34,28.3,71.7
1,0,0,3,-1,268,411,143,34.8,65.2
1,0,0,3,0,1078,1939,861,44.4,55.6
1,0,0,13,-7,1,1,0,0,100
1,0,0,13,-6,3,4,1,25,75
1,0,0,13,-5,9,9,0,0,100
1,0,0,13,-4,20,20,0,0,100
1,0,0,13,-3,53,65,12,18.5,81.5
1,0,0,13,-2,174,225,51,22.7,77.3
1,0,0,13,-1,520,784,264,33.7,66.3
1,0,0,13,0,1805,3111,1306,42,58
1,0,0,23,-6,1,1,0,0,100
1,0,0,23,-5,4,4,0,0,100
1,0,0,23,-4,11,14,3,21.4,78.6
1,0,0,23,-3,50,61,11,18,82
1,0,0,23,-2,113,143,30,21,79
1,0,0,23,-1,324,446,122,27.4,72.6
1,0,0,23,0,826,1359,533,39.2,60.8
1,0,0,123,-7,1,1,0,0,100
1,0,0,123,-6,2,2,0,0,100
1,0,0,123,-5,8,8,0,0,100
1,0,0,123,-4,19,19,0,0,100
1,0,0,123,-3,47,49,2,4.1,95.9
1,0,0,123,-2,142,168,26,15.5,84.5
1,0,0,123,-1,320,442,122,27.6,72.4
1,0,0,123,0,833,1308,475,36.3,63.7
1,0,1,0,-10,2,2,0,0,100
1,0,1,0,-9,4,5,1,20,80
1,0,1,0,-8,2,2,0,0,100
1,0,1,0,-7,7,7,0,0,100
1,0,1,0,-6,43,46,3,6.5,93.5
1,0,1,0,-5,139,158,19,12,88
1,0,1,0,-4,371,456,85,18.6,81.4
1,0,1,0,-3,814,1123,309,27.5,72.5
1,0,1,0,-2,1267,1948,681,35,65
1,0,1,0,-1,1857,3379,1522,45,55
1,0,1,0,0,39572,89354,49782,55.7,44.3
1,0,1,1,-9,2,2,0,0,100
1,0,1,1,-8,1,1,0,0,100
1,0,1,1,-7,7,7,0,0,100
1,0,1,1,-6,28,31,3,9.7,90.3
1,0,1,1,-5,86,96,10,10.4,89.6
1,0,1,1,-4,223,258,35,13.6,86.4
1,0,1,1,-3,447,596,149,25,75
1,0,1,1,-2,914,1427,513,35.9,64.1
1,0,1,1,-1,2179,3838,1659,43.2,56.8
1,0,1,1,0,15893,33544,17651,52.6,47.4
1,0,1,1,2,1,1,0,0,100
1,0,1,2,-9,1,1,0,0,100
1,0,1,2,-8,5,5,0,0,100
1,0,1,2,-7,4,4,0,0,100
1,0,1,2,-6,19,19,0,0,100
1,0,1,2,-5,48,54,6,11.1,88.9
1,0,1,2,-4,127,146,19,13,87
1,0,1,2,-3,343,435,92,21.1,78.9
1,0,1,2,-2,715,1050,335,31.9,68.1
1,0,1,2,-1,1685,2942,1257,42.7,57.3
1,0,1,2,0,7153,14530,7377,50.8,49.2
1,0,1,12,-8,1,1,0,0,100
1,0,1,12,-7,1,1,0,0,100
1,0,1,12,-6,16,21,5,23.8,76.2
1,0,1,12,-5,55,59,4,6.8,93.2
1,0,1,12,-4,152,179,27,15.1,84.9
1,0,1,12,-3,322,407,85,20.9,79.1
1,0,1,12,-2,726,1084,358,33,67
1,0,1,12,-1,1585,2653,1068,40.3,59.7
1,0,1,12,0,4996,9734,4738,48.7,51.3
1,0,1,3,-8,4,4,0,0,100
1,0,1,3,-7,4,4,0,0,100
1,0,1,3,-6,9,9,0,0,100
1,0,1,3,-5,27,29,2,6.9,93.1
1,0,1,3,-4,64,76,12,15.8,84.2
1,0,1,3,-3,134,176,42,23.9,76.1
1,0,1,3,-2,333,473,140,29.6,70.4
1,0,1,3,-1,806,1330,524,39.4,60.6
1,0,1,3,0,2860,5443,2583,47.5,52.5
1,0,1,13,-9,1,1,0,0,100
1,0,1,13,-8,1,1,0,0,100
1,0,1,13,-7,4,4,0,0,100
1,0,1,13,-6,16,17,1,5.9,94.1
1,0,1,13,-5,34,37,3,8.1,91.9
1,0,1,13,-4,99,112,13,11.6,88.4
1,0,1,13,-3,215,270,55,20.4,79.6
1,0,1,13,-2,497,666,169,25.4,74.6
1,0,1,13,-1,1115,1771,656,37,63
1,0,1,13,0,2573,4741,2168,45.7,54.3
1,0,1,13,2,1,1,0,0,100
1,0,1,23,-9,1,1,0,0,100
1,0,1,23,-8,2,2,0,0,100
1,0,1,23,-7,7,7,0,0,100
1,0,1,23,-6,14,15,1,6.7,93.3
1,0,1,23,-5,23,28,5,17.9,82.1
1,0,1,23,-4,60,73,13,17.8,82.2
1,0,1,23,-3,155,192,37,19.3,80.7
1,0,1,23,-2,328,451,123,27.3,72.7
1,0,1,23,-1,698,1076,378,35.1,64.9
1,0,1,23,0,1523,2763,1240,44.9,55.1
1,0,1,123,-8,1,1,0,0,100
1,0,1,123,-7,5,5,0,0,100
1,0,1,123,-6,10,10,0,0,100
1,0,1,123,-5,20,20,0,0,100
1,0,1,123,-4,67,78,11,14.1,85.9
1,0,1,123,-3,171,206,35,17,83
1,0,1,123,-2,415,575,160,27.8,72.2
1,0,1,123,-1,806,1227,421,34.3,65.7
1,0,1,123,0,1514,2587,1073,41.5,58.5
1,0,2,0,-11,3,3,0,0,100
1,0,2,0,-10,5,5,0,0,100
1,0,2,0,-9,7,8,1,12.5,87.5
1,0,2,0,-8,5,5,0,0,100
1,0,2,0,-7,19,19,0,0,100
1,0,2,0,-6,72,78,6,7.7,92.3
1,0,2,0,-5,235,276,41,14.9,85.1
1,0,2,0,-4,610,759,149,19.6,80.4
1,0,2,0,-3,1208,1735,527,30.4,69.6
1,0,2,0,-2,2205,3462,1257,36.3,63.7
1,0,2,0,-1,3361,6296,2935,46.6,53.4
1,0,2,0,0,28041,65811,37770,57.4,42.6
1,0,2,1,-11,2,2,0,0,100
1,0,2,1,-10,5,5,0,0,100
1,0,2,1,-9,10,11,1,9.1,90.9
1,0,2,1,-8,9,9,0,0,100
1,0,2,1,-7,27,30,3,10,90
1,0,2,1,-6,53,58,5,8.6,91.4
1,0,2,1,-5,168,192,24,12.5,87.5
1,0,2,1,-4,448,534,86,16.1,83.9
1,0,2,1,-3,892,1213,321,26.5,73.5
1,0,2,1,-2,1778,2753,975,35.4,64.6
1,0,2,1,-1,3438,6203,2765,44.6,55.4
1,0,2,1,0,13036,29669,16633,56.1,43.9
1,0,2,2,-9,4,4,0,0,100
1,0,2,2,-8,12,12,0,0,100
1,0,2,2,-7,18,18,0,0,100
1,0,2,2,-6,56,61,5,8.2,91.8
1,0,2,2,-5,144,165,21,12.7,87.3
1,0,2,2,-4,343,414,71,17.1,82.9
1,0,2,2,-3,685,944,259,27.4,72.6
1,0,2,2,-2,1306,2031,725,35.7,64.3
1,0,2,2,-1,2444,4477,2033,45.4,54.6
1,0,2,2,0,6404,14185,7781,54.9,45.1
1,0,2,12,-10,1,1,0,0,100
1,0,2,12,-9,2,3,1,33.3,66.7
1,0,2,12,-8,8,8,0,0,100
1,0,2,12,-7,19,19,0,0,100
1,0,2,12,-6,56,58,2,3.4,96.6
1,0,2,12,-5,117,132,15,11.4,88.6
1,0,2,12,-4,342,408,66,16.2,83.8
1,0,2,12,-3,604,812,208,25.6,74.4
1,0,2,12,-2,1186,1823,637,34.9,65.1
1,0,2,12,-1,2220,3984,1764,44.3,55.7
1,0,2,12,0,4971,10868,5897,54.3,45.7
1,0,2,3,-11,1,1,0,0,100
1,0,2,3,-10,1,1,0,0,100
1,0,2,3,-9,1,1,0,0,100
1,0,2,3,-8,4,5,1,20,80
1,0,2,3,-7,10,10,0,0,100
1,0,2,3,-6,18,20,2,10,90
1,0,2,3,-5,62,77,15,19.5,80.5
1,0,2,3,-4,132,158,26,16.5,83.5
1,0,2,3,-3,277,382,105,27.5,72.5
1,0,2,3,-2,606,924,318,34.4,65.6
1,0,2,3,-1,1153,2100,947,45.1,54.9
1,0,2,3,0,2808,5932,3124,52.7,47.3
1,0,2,13,-10,0,1,1,100,0
1,0,2,13,-9,1,1,0,0,100
1,0,2,13,-8,6,6,0,0,100
1,0,2,13,-7,11,11,0,0,100
1,0,2,13,-6,29,35,6,17.1,82.9
1,0,2,13,-5,67,77,10,13,87
1,0,2,13,-4,169,195,26,13.3,86.7
1,0,2,13,-3,351,467,116,24.8,75.2
1,0,2,13,-2,703,1042,339,32.5,67.5
1,0,2,13,-1,1334,2305,971,42.1,57.9
1,0,2,13,0,2203,4626,2423,52.4,47.6
1,0,2,23,-9,1,1,0,0,100
1,0,2,23,-7,6,6,0,0,100
1,0,2,23,-6,15,16,1,6.2,93.8
1,0,2,23,-5,46,54,8,14.8,85.2
1,0,2,23,-4,100,115,15,13,87
1,0,2,23,-3,221,290,69,23.8,76.2
1,0,2,23,-2,453,647,194,30,70
1,0,2,23,-1,778,1278,500,39.1,60.9
1,0,2,23,0,1113,2311,1198,51.8,48.2
1,0,2,123,-10,2,3,1,33.3,66.7
1,0,2,123,-9,2,2,0,0,100
1,0,2,123,-8,4,4,0,0,100
1,0,2,123,-7,10,10,0,0,100
1,0,2,123,-6,15,17,2,11.8,88.2
1,0,2,123,-5,44,47,3,6.4,93.6
1,0,2,123,-4,91,110,19,17.3,82.7
1,0,2,123,-3,285,384,99,25.8,74.2
1,0,2,123,-2,498,728,230,31.6,68.4
1,0,2,123,-1,879,1524,645,42.3,57.7
1,0,2,123,0,1467,2884,1417,49.1,50.9
1,1,0,0,-11,4,4,0,0,100
1,1,0,0,-10,9,10,1,10,90
1,1,0,0,-9,18,18,0,0,100
1,1,0,0,-8,29,30,1,3.3,96.7
1,1,0,0,-7,83,86,3,3.5,96.5
1,1,0,0,-6,233,254,21,8.3,91.7
1,1,0,0,-5,672,785,113,14.4,85.6
1,1,0,0,-4,1596,1961,365,18.6,81.4
1,1,0,0,-3,3158,4468,1310,29.3,70.7
1,1,0,0,-2,6019,9603,3584,37.3,62.7
1,1,0,0,-1,10389,19880,9491,47.7,52.3
1,1,0,0,0,38866,93487,54621,58.4,41.6
1,1,0,0,1,498,1620,1122,69.3,30.7
1,1,0,0,2,146,601,455,75.7,24.3
1,1,0,0,3,62,363,301,82.9,17.1
1,1,0,0,4,14,183,169,92.3,7.69999999999999
1,1,0,0,5,0,39,39,100,0
1,1,0,0,6,1,11,10,90.9,9.09999999999999
1,1,0,0,7,0,4,4,100,0
1,1,0,0,8,0,2,2,100,0
1,1,0,1,-10,2,2,0,0,100
1,1,0,1,-9,5,5,0,0,100
1,1,0,1,-8,11,11,0,0,100
1,1,0,1,-7,28,29,1,3.4,96.6
1,1,0,1,-6,65,68,3,4.4,95.6
1,1,0,1,-5,196,227,31,13.7,86.3
1,1,0,1,-4,447,579,132,22.8,77.2
1,1,0,1,-3,926,1387,461,33.2,66.8
1,1,0,1,-2,1600,2787,1187,42.6,57.4
1,1,0,1,-1,2747,5836,3089,52.9,47.1
1,1,0,1,0,10166,27037,16871,62.4,37.6
1,1,0,1,1,327,1171,844,72.1,27.9
1,1,0,1,2,79,396,317,80.1,19.9
1,1,0,1,3,28,176,148,84.1,15.9
1,1,0,1,4,6,73,67,91.8,8.2
1,1,0,1,5,1,21,20,95.2,4.80000000000001
1,1,0,1,6,1,7,6,85.7,14.3
1,1,0,1,7,0,1,1,100,0
1,1,0,1,9,0,1,1,100,0
1,1,0,2,-10,0,1,1,100,0
1,1,0,2,-9,1,1,0,0,100
1,1,0,2,-8,8,9,1,11.1,88.9
1,1,0,2,-7,10,11,1,9.1,90.9
1,1,0,2,-6,12,16,4,25,75
1,1,0,2,-5,66,76,10,13.2,86.8
1,1,0,2,-4,126,166,40,24.1,75.9
1,1,0,2,-3,207,337,130,38.6,61.4
1,1,0,2,-2,463,835,372,44.6,55.4
1,1,0,2,-1,810,1841,1031,56,44
1,1,0,2,0,2959,8446,5487,65,35
1,1,0,2,1,262,1056,794,75.2,24.8
1,1,0,2,2,78,402,324,80.6,19.4
1,1,0,2,3,19,151,132,87.4,12.6
1,1,0,2,4,6,62,56,90.3,9.7
1,1,0,2,5,1,14,13,92.9,7.09999999999999
1,1,0,2,6,0,4,4,100,0
1,1,0,2,7,0,1,1,100,0
1,1,0,12,-9,1,1,0,0,100
1,1,0,12,-8,3,3,0,0,100
1,1,0,12,-7,11,11,0,0,100
1,1,0,12,-6,22,24,2,8.3,91.7
1,1,0,12,-5,52,60,8,13.3,86.7
1,1,0,12,-4,105,150,45,30,70
1,1,0,12,-3,212,343,131,38.2,61.8
1,1,0,12,-2,318,652,334,51.2,48.8
1,1,0,12,-1,499,1242,743,59.8,40.2
1,1,0,12,0,1754,5648,3894,68.9,31.1
1,1,0,12,1,225,949,724,76.3,23.7
1,1,0,12,2,68,344,276,80.2,19.8
1,1,0,12,3,20,110,90,81.8,18.2
1,1,0,12,4,2,49,47,95.9,4.10000000000001
1,1,0,12,5,2,21,19,90.5,9.5
1,1,0,12,6,2,8,6,75,25
1,1,0,12,7,0,1,1,100,0
1,1,0,12,8,0,1,1,100,0
1,1,0,3,-11,1,1,0,0,100
1,1,0,3,-8,1,1,0,0,100
1,1,0,3,-7,3,3,0,0,100
1,1,0,3,-6,4,4,0,0,100
1,1,0,3,-5,7,9,2,22.2,77.8
1,1,0,3,-4,16,20,4,20,80
1,1,0,3,-3,52,74,22,29.7,70.3
1,1,0,3,-2,85,156,71,45.5,54.5
1,1,0,3,-1,173,380,207,54.5,45.5
1,1,0,3,0,571,1721,1150,66.8,33.2
1,1,0,3,1,114,450,336,74.7,25.3
1,1,0,3,2,17,135,118,87.4,12.6
1,1,0,3,3,8,41,33,80.5,19.5
1,1,0,3,4,1,19,18,94.7,5.30000000000001
1,1,0,3,5,0,9,9,100,0
1,1,0,3,6,0,1,1,100,0
1,1,0,3,7,0,1,1,100,0
1,1,0,3,8,0,1,1,100,0
1,1,0,13,-10,1,1,0,0,100
1,1,0,13,-9,1,1,0,0,100
1,1,0,13,-8,1,1,0,0,100
1,1,0,13,-7,4,4,0,0,100
1,1,0,13,-6,4,4,0,0,100
1,1,0,13,-5,12,13,1,7.7,92.3
1,1,0,13,-4,38,49,11,22.4,77.6
1,1,0,13,-3,75,111,36,32.4,67.6
1,1,0,13,-2,142,286,144,50.3,49.7
1,1,0,13,-1,250,629,379,60.3,39.7
1,1,0,13,0,820,2704,1884,69.7,30.3
1,1,0,13,1,158,718,560,78,22
1,1,0,13,2,37,234,197,84.2,15.8
1,1,0,13,3,6,80,74,92.5,7.5
1,1,0,13,4,1,24,23,95.8,4.2
1,1,0,13,5,0,14,14,100,0
1,1,0,13,6,0,3,3,100,0
1,1,0,23,-8,1,1,0,0,100
1,1,0,23,-6,2,3,1,33.3,66.7
1,1,0,23,-5,5,9,4,44.4,55.6
1,1,0,23,-4,12,24,12,50,50
1,1,0,23,-3,41,72,31,43.1,56.9
1,1,0,23,-2,62,135,73,54.1,45.9
1,1,0,23,-1,106,261,155,59.4,40.6
1,1,0,23,0,341,1241,900,72.5,27.5
1,1,0,23,1,93,460,367,79.8,20.2
1,1,0,23,2,25,163,138,84.7,15.3
1,1,0,23,3,2,47,45,95.7,4.3
1,1,0,23,4,4,21,17,81,19
1,1,0,23,5,0,3,3,100,0
1,1,0,23,6,0,2,2,100,0
1,1,0,123,-8,1,1,0,0,100
1,1,0,123,-7,4,4,0,0,100
1,1,0,123,-6,4,4,0,0,100
1,1,0,123,-5,5,6,1,16.7,83.3
1,1,0,123,-4,22,38,16,42.1,57.9
1,1,0,123,-3,41,68,27,39.7,60.3
1,1,0,123,-2,70,164,94,57.3,42.7
1,1,0,123,-1,101,304,203,66.8,33.2
1,1,0,123,0,331,1265,934,73.8,26.2
1,1,0,123,1,75,408,333,81.6,18.4
1,1,0,123,2,24,176,152,86.4,13.6
1,1,0,123,3,8,58,50,86.2,13.8
1,1,0,123,4,2,24,22,91.7,8.3
1,1,0,123,5,1,7,6,85.7,14.3
1,1,0,123,6,0,4,4,100,0
1,1,0,123,7,0,1,1,100,0
1,1,1,0,-11,3,3,0,0,100
1,1,1,0,-10,8,8,0,0,100
1,1,1,0,-9,12,12,0,0,100
1,1,1,0,-8,11,12,1,8.3,91.7
1,1,1,0,-7,47,49,2,4.1,95.9
1,1,1,0,-6,149,163,14,8.6,91.4
1,1,1,0,-5,432,506,74,14.6,85.4
1,1,1,0,-4,1075,1290,215,16.7,83.3
1,1,1,0,-3,2108,2866,758,26.4,73.6
1,1,1,0,-2,4216,6412,2196,34.2,65.8
1,1,1,0,-1,7413,13348,5935,44.5,55.5
1,1,1,0,0,27452,62138,34686,55.8,44.2
1,1,1,0,1,956,2935,1979,67.4,32.6
1,1,1,0,2,471,1954,1483,75.9,24.1
1,1,1,0,3,185,1086,901,83,17
1,1,1,0,4,43,456,413,90.6,9.39999999999999
1,1,1,0,5,12,146,134,91.8,8.2
1,1,1,0,6,4,51,47,92.2,7.8
1,1,1,0,7,1,19,18,94.7,5.30000000000001
1,1,1,0,8,0,2,2,100,0
1,1,1,0,9,0,4,4,100,0
1,1,1,0,11,0,2,2,100,0
1,1,1,1,-10,1,1,0,0,100
1,1,1,1,-9,7,7,0,0,100
1,1,1,1,-8,10,11,1,9.1,90.9
1,1,1,1,-7,23,24,1,4.2,95.8
1,1,1,1,-6,67,73,6,8.2,91.8
1,1,1,1,-5,188,219,31,14.2,85.8
1,1,1,1,-4,499,618,119,19.3,80.7
1,1,1,1,-3,961,1354,393,29,71
1,1,1,1,-2,1730,2781,1051,37.8,62.2
1,1,1,1,-1,2924,5685,2761,48.6,51.4
1,1,1,1,0,10375,25323,14948,59,41
1,1,1,1,1,1093,3477,2384,68.6,31.4
1,1,1,1,2,301,1377,1076,78.1,21.9
1,1,1,1,3,103,584,481,82.4,17.6
1,1,1,1,4,24,283,259,91.5,8.5
1,1,1,1,5,7,79,72,91.1,8.89999999999999
1,1,1,1,6,1,41,40,97.6,2.40000000000001
1,1,1,1,7,0,5,5,100,0
1,1,1,1,8,0,2,2,100,0
1,1,1,1,9,0,2,2,100,0
1,1,1,1,11,0,1,1,100,0
1,1,1,2,-10,2,3,1,33.3,66.7
1,1,1,2,-9,1,1,0,0,100
1,1,1,2,-8,2,3,1,33.3,66.7
1,1,1,2,-7,8,10,2,20,80
1,1,1,2,-6,23,26,3,11.5,88.5
1,1,1,2,-5,77,98,21,21.4,78.6
1,1,1,2,-4,181,225,44,19.6,80.4
1,1,1,2,-3,328,495,167,33.7,66.3
1,1,1,2,-2,674,1145,471,41.1,58.9
1,1,1,2,-1,1275,2521,1246,49.4,50.6
1,1,1,2,0,4679,11863,7184,60.6,39.4
1,1,1,2,1,791,2658,1867,70.2,29.8
1,1,1,2,2,246,1086,840,77.3,22.7
1,1,1,2,3,81,446,365,81.8,18.2
1,1,1,2,4,20,196,176,89.8,10.2
1,1,1,2,5,7,69,62,89.9,10.1
1,1,1,2,6,1,26,25,96.2,3.8
1,1,1,2,7,0,11,11,100,0
1,1,1,2,8,0,1,1,100,0
1,1,1,2,11,0,1,1,100,0
1,1,1,2,13,0,1,1,100,0
1,1,1,12,-9,2,2,0,0,100
1,1,1,12,-8,2,2,0,0,100
1,1,1,12,-7,4,4,0,0,100
1,1,1,12,-6,34,35,1,2.9,97.1
1,1,1,12,-5,79,87,8,9.2,90.8
1,1,1,12,-4,146,202,56,27.7,72.3
1,1,1,12,-3,307,457,150,32.8,67.2
1,1,1,12,-2,509,931,422,45.3,54.7
1,1,1,12,-1,957,1935,978,50.5,49.5
1,1,1,12,0,3039,8149,5110,62.7,37.3
1,1,1,12,1,656,2321,1665,71.7,28.3
1,1,1,12,2,214,1009,795,78.8,21.2
1,1,1,12,3,54,439,385,87.7,12.3
1,1,1,12,4,17,162,145,89.5,10.5
1,1,1,12,5,6,79,73,92.4,7.59999999999999
1,1,1,12,6,1,19,18,94.7,5.30000000000001
1,1,1,12,7,0,6,6,100,0
1,1,1,12,8,0,3,3,100,0
1,1,1,12,9,0,2,2,100,0
1,1,1,12,11,0,1,1,100,0
1,1,1,12,14,0,1,1,100,0
1,1,1,3,-9,1,1,0,0,100
1,1,1,3,-8,3,3,0,0,100
1,1,1,3,-7,6,6,0,0,100
1,1,1,3,-6,9,10,1,10,90
1,1,1,3,-5,20,24,4,16.7,83.3
1,1,1,3,-4,76,95,19,20,80
1,1,1,3,-3,135,193,58,30.1,69.9
1,1,1,3,-2,258,464,206,44.4,55.6
1,1,1,3,-1,494,1043,549,52.6,47.4
1,1,1,3,0,1725,4674,2949,63.1,36.9
1,1,1,3,1,365,1287,922,71.6,28.4
1,1,1,3,2,94,484,390,80.6,19.4
1,1,1,3,3,31,202,171,84.7,15.3
1,1,1,3,4,6,86,80,93,7
1,1,1,3,5,2,30,28,93.3,6.69999999999999
1,1,1,3,6,0,8,8,100,0
1,1,1,3,7,0,4,4,100,0
1,1,1,13,-8,1,1,0,0,100
1,1,1,13,-7,7,9,2,22.2,77.8
1,1,1,13,-6,8,8,0,0,100
1,1,1,13,-5,29,37,8,21.6,78.4
1,1,1,13,-4,71,87,16,18.4,81.6
1,1,1,13,-3,126,191,65,34,66
1,1,1,13,-2,252,460,208,45.2,54.8
1,1,1,13,-1,438,987,549,55.6,44.4
1,1,1,13,0,1420,4100,2680,65.4,34.6
1,1,1,13,1,454,1606,1152,71.7,28.3
1,1,1,13,2,117,623,506,81.2,18.8
1,1,1,13,3,36,268,232,86.6,13.4
1,1,1,13,4,10,115,105,91.3,8.7
1,1,1,13,5,5,41,36,87.8,12.2
1,1,1,13,6,1,8,7,87.5,12.5
1,1,1,13,7,0,5,5,100,0
1,1,1,13,8,0,1,1,100,0
1,1,1,13,9,0,3,3,100,0
1,1,1,13,10,0,2,2,100,0
1,1,1,13,13,0,1,1,100,0
1,1,1,23,-8,1,1,0,0,100
1,1,1,23,-7,2,2,0,0,100
1,1,1,23,-6,6,6,0,0,100
1,1,1,23,-5,12,19,7,36.8,63.2
1,1,1,23,-4,41,53,12,22.6,77.4
1,1,1,23,-3,93,136,43,31.6,68.4
1,1,1,23,-2,149,297,148,49.8,50.2
1,1,1,23,-1,231,548,317,57.8,42.2
1,1,1,23,0,775,2435,1660,68.2,31.8
1,1,1,23,1,242,979,737,75.3,24.7
1,1,1,23,2,76,460,384,83.5,16.5
1,1,1,23,3,28,204,176,86.3,13.7
1,1,1,23,4,7,69,62,89.9,10.1
1,1,1,23,5,0,23,23,100,0
1,1,1,23,6,1,4,3,75,25
1,1,1,23,7,0,3,3,100,0
1,1,1,123,-9,1,1,0,0,100
1,1,1,123,-7,4,4,0,0,100
1,1,1,123,-6,5,5,0,0,100
1,1,1,123,-5,21,21,0,0,100
1,1,1,123,-4,56,79,23,29.1,70.9
1,1,1,123,-3,75,125,50,40,60
1,1,1,123,-2,146,287,141,49.1,50.9
1,1,1,123,-1,218,550,332,60.4,39.6
1,1,1,123,0,757,2458,1701,69.2,30.8
1,1,1,123,1,275,1166,891,76.4,23.6
1,1,1,123,2,83,517,434,83.9,16.1
1,1,1,123,3,28,214,186,86.9,13.1
1,1,1,123,4,2,71,69,97.2,2.8
1,1,1,123,5,3,27,24,88.9,11.1
1,1,1,123,6,1,9,8,88.9,11.1
1,1,1,123,7,0,6,6,100,0
1,1,1,123,8,0,1,1,100,0
1,1,1,123,9,0,3,3,100,0
1,1,1,123,10,0,1,1,100,0
1,1,1,123,14,0,1,1,100,0
1,1,2,0,-11,3,3,0,0,100
1,1,2,0,-10,7,7,0,0,100
1,1,2,0,-9,8,8,0,0,100
1,1,2,0,-8,10,10,0,0,100
1,1,2,0,-7,37,38,1,2.6,97.4
1,1,2,0,-6,108,114,6,5.3,94.7
1,1,2,0,-5,324,368,44,12,88
1,1,2,0,-4,777,911,134,14.7,85.3
1,1,2,0,-3,1591,2115,524,24.8,75.2
1,1,2,0,-2,3217,4721,1504,31.9,68.1
1,1,2,0,-1,5754,9975,4221,42.3,57.7
1,1,2,0,0,21075,45651,24576,53.8,46.2
1,1,2,0,1,1940,5614,3674,65.4,34.6
1,1,2,0,2,825,3232,2407,74.5,25.5
1,1,2,0,3,295,1711,1416,82.8,17.2
1,1,2,0,4,86,726,640,88.2,11.8
1,1,2,0,5,17,289,272,94.1,5.90000000000001
1,1,2,0,6,9,101,92,91.1,8.89999999999999
1,1,2,0,7,1,37,36,97.3,2.7
1,1,2,0,8,1,15,14,93.3,6.69999999999999
1,1,2,0,9,0,9,9,100,0
1,1,2,0,10,0,3,3,100,0
1,1,2,0,11,0,3,3,100,0
1,1,2,0,12,0,1,1,100,0
1,1,2,0,13,0,1,1,100,0
1,1,2,0,14,0,1,1,100,0
1,1,2,1,-10,2,2,0,0,100
1,1,2,1,-9,4,4,0,0,100
1,1,2,1,-8,4,4,0,0,100
1,1,2,1,-7,21,21,0,0,100
1,1,2,1,-6,58,62,4,6.5,93.5
1,1,2,1,-5,183,200,17,8.5,91.5
1,1,2,1,-4,440,512,72,14.1,85.9
1,1,2,1,-3,867,1140,273,23.9,76.1
1,1,2,1,-2,1706,2477,771,31.1,68.9
1,1,2,1,-1,2897,5137,2240,43.6,56.4
1,1,2,1,0,9793,22151,12358,55.8,44.2
1,1,2,1,1,1879,5477,3598,65.7,34.3
1,1,2,1,2,642,2609,1967,75.4,24.6
1,1,2,1,3,221,1192,971,81.5,18.5
1,1,2,1,4,62,557,495,88.9,11.1
1,1,2,1,5,13,189,176,93.1,6.89999999999999
1,1,2,1,6,4,82,78,95.1,4.90000000000001
1,1,2,1,7,3,38,35,92.1,7.89999999999999
1,1,2,1,8,1,9,8,88.9,11.1
1,1,2,1,9,0,5,5,100,0
1,1,2,1,10,0,3,3,100,0
1,1,2,1,11,0,2,2,100,0
1,1,2,1,12,0,1,1,100,0
1,1,2,2,-11,1,1,0,0,100
1,1,2,2,-10,2,2,0,0,100
1,1,2,2,-8,4,5,1,20,80
1,1,2,2,-7,7,7,0,0,100
1,1,2,2,-6,21,24,3,12.5,87.5
1,1,2,2,-5,63,87,24,27.6,72.4
1,1,2,2,-4,194,228,34,14.9,85.1
1,1,2,2,-3,425,573,148,25.8,74.2
1,1,2,2,-2,749,1145,396,34.6,65.4
1,1,2,2,-1,1386,2551,1165,45.7,54.3
1,1,2,2,0,4850,11314,6464,57.1,42.9
1,1,2,2,1,1338,4035,2697,66.8,33.2
1,1,2,2,2,509,2048,1539,75.1,24.9
1,1,2,2,3,180,966,786,81.4,18.6
1,1,2,2,4,40,461,421,91.3,8.7
1,1,2,2,5,17,165,148,89.7,10.3
1,1,2,2,6,5,77,72,93.5,6.5
1,1,2,2,7,0,25,25,100,0
1,1,2,2,8,0,10,10,100,0
1,1,2,2,9,0,5,5,100,0
1,1,2,2,10,0,2,2,100,0
1,1,2,2,11,0,1,1,100,0
1,1,2,12,-9,3,3,0,0,100
1,1,2,12,-8,4,4,0,0,100
1,1,2,12,-7,6,6,0,0,100
1,1,2,12,-6,23,24,1,4.2,95.8
1,1,2,12,-5,74,84,10,11.9,88.1
1,1,2,12,-4,165,202,37,18.3,81.7
1,1,2,12,-3,360,484,124,25.6,74.4
1,1,2,12,-2,671,1039,368,35.4,64.6
1,1,2,12,-1,1127,2094,967,46.2,53.8
1,1,2,12,0,3755,8890,5135,57.8,42.2
1,1,2,12,1,1150,3565,2415,67.7,32.3
1,1,2,12,2,391,1781,1390,78,22
1,1,2,12,3,125,798,673,84.3,15.7
1,1,2,12,4,37,383,346,90.3,9.7
1,1,2,12,5,8,125,117,93.6,6.39999999999999
1,1,2,12,6,1,54,53,98.1,1.90000000000001
1,1,2,12,7,0,31,31,100,0
1,1,2,12,8,1,10,9,90,10
1,1,2,12,9,0,5,5,100,0
1,1,2,12,10,0,4,4,100,0
1,1,2,12,11,0,3,3,100,0
1,1,2,12,14,0,1,1,100,0
1,1,2,3,-10,1,1,0,0,100
1,1,2,3,-9,1,1,0,0,100
1,1,2,3,-8,1,1,0,0,100
1,1,2,3,-7,8,9,1,11.1,88.9
1,1,2,3,-6,9,10,1,10,90
1,1,2,3,-5,31,36,5,13.9,86.1
1,1,2,3,-4,94,113,19,16.8,83.2
1,1,2,3,-3,151,209,58,27.8,72.2
1,1,2,3,-2,317,507,190,37.5,62.5
1,1,2,3,-1,619,1144,525,45.9,54.1
1,1,2,3,0,2144,4957,2813,56.7,43.3
1,1,2,3,1,626,1941,1315,67.7,32.3
1,1,2,3,2,239,944,705,74.7,25.3
1,1,2,3,3,74,432,358,82.9,17.1
1,1,2,3,4,14,196,182,92.9,7.09999999999999
1,1,2,3,5,10,71,61,85.9,14.1
1,1,2,3,6,1,21,20,95.2,4.80000000000001
1,1,2,3,7,0,13,13,100,0
1,1,2,3,8,0,6,6,100,0
1,1,2,3,9,0,2,2,100,0
1,1,2,3,10,0,1,1,100,0
1,1,2,3,11,0,1,1,100,0
1,1,2,13,-7,4,5,1,20,80
1,1,2,13,-6,13,13,0,0,100
1,1,2,13,-5,28,33,5,15.2,84.8
1,1,2,13,-4,78,91,13,14.3,85.7
1,1,2,13,-3,173,221,48,21.7,78.3
1,1,2,13,-2,289,453,164,36.2,63.8
1,1,2,13,-1,527,1011,484,47.9,52.1
1,1,2,13,0,1683,4098,2415,58.9,41.1
1,1,2,13,1,655,2087,1432,68.6,31.4
1,1,2,13,2,243,1023,780,76.2,23.8
1,1,2,13,3,89,497,408,82.1,17.9
1,1,2,13,4,22,205,183,89.3,10.7
1,1,2,13,5,10,73,63,86.3,13.7
1,1,2,13,6,2,32,30,93.8,6.2
1,1,2,13,7,0,18,18,100,0
1,1,2,13,8,0,7,7,100,0
1,1,2,13,9,0,3,3,100,0
1,1,2,13,10,0,6,6,100,0
1,1,2,13,11,0,1,1,100,0
1,1,2,13,13,0,1,1,100,0
1,1,2,23,-6,5,5,0,0,100
1,1,2,23,-5,19,21,2,9.5,90.5
1,1,2,23,-4,45,52,7,13.5,86.5
1,1,2,23,-3,90,118,28,23.7,76.3
1,1,2,23,-2,146,250,104,41.6,58.4
1,1,2,23,-1,268,499,231,46.3,53.7
1,1,2,23,0,811,1981,1170,59.1,40.9
1,1,2,23,1,361,1181,820,69.4,30.6
1,1,2,23,2,136,609,473,77.7,22.3
1,1,2,23,3,41,295,254,86.1,13.9
1,1,2,23,4,15,112,97,86.6,13.4
1,1,2,23,5,4,69,65,94.2,5.80000000000001
1,1,2,23,6,1,15,14,93.3,6.69999999999999
1,1,2,23,7,0,17,17,100,0
1,1,2,23,8,0,3,3,100,0
1,1,2,23,9,1,2,1,50,50
1,1,2,23,10,0,2,2,100,0
1,1,2,23,11,0,1,1,100,0
1,1,2,23,12,0,1,1,100,0
1,1,2,123,-9,1,1,0,0,100
1,1,2,123,-8,1,1,0,0,100
1,1,2,123,-7,1,1,0,0,100
1,1,2,123,-6,9,9,0,0,100
1,1,2,123,-5,28,29,1,3.4,96.6
1,1,2,123,-4,46,57,11,19.3,80.7
1,1,2,123,-3,109,154,45,29.2,70.8
1,1,2,123,-2,202,351,149,42.5,57.5
1,1,2,123,-1,313,632,319,50.5,49.5
1,1,2,123,0,1011,2641,1630,61.7,38.3
1,1,2,123,1,424,1418,994,70.1,29.9
1,1,2,123,2,142,713,571,80.1,19.9
1,1,2,123,3,55,384,329,85.7,14.3
1,1,2,123,4,9,131,122,93.1,6.89999999999999
1,1,2,123,5,5,69,64,92.8,7.19999999999999
1,1,2,123,6,0,15,15,100,0
1,1,2,123,7,0,10,10,100,0
1,1,2,123,8,0,7,7,100,0
1,1,2,123,9,0,3,3,100,0
1,1,2,123,10,0,4,4,100,0
1,1,2,123,11,0,1,1,100,0
1,1,2,123,12,0,1,1,100,0
1,1,2,123,14,0,2,2,100,0
1,1,2,123,15,0,1,1,100,0
2,0,0,0,-11,3,3,0,0,100
2,0,0,0,-10,10,10,0,0,100
2,0,0,0,-9,18,18,0,0,100
2,0,0,0,-8,29,31,2,6.5,93.5
2,0,0,0,-7,76,80,4,5,95
2,0,0,0,-6,203,213,10,4.7,95.3
2,0,0,0,-5,547,624,77,12.3,87.7
2,0,0,0,-4,1394,1628,234,14.4,85.6
2,0,0,0,-3,2948,3816,868,22.7,77.3
2,0,0,0,-2,5826,8388,2562,30.5,69.5
2,0,0,0,-1,10518,17772,7254,40.8,59.2
2,0,0,0,0,32356,68194,35838,52.6,47.4
2,0,0,0,1,6406,17700,11294,63.8,36.2
2,0,0,0,2,2387,9103,6716,73.8,26.2
2,0,0,0,3,830,4407,3577,81.2,18.8
2,0,0,0,4,226,2027,1801,88.9,11.1
2,0,0,0,5,72,779,707,90.8,9.2
2,0,0,0,6,18,279,261,93.5,6.5
2,0,0,0,7,4,116,112,96.6,3.40000000000001
2,0,0,0,8,0,38,38,100,0
2,0,0,0,9,1,20,19,95,5
2,0,0,0,10,0,13,13,100,0
2,0,0,0,11,0,7,7,100,0
2,0,0,0,12,0,1,1,100,0
2,0,0,0,13,0,3,3,100,0
2,0,0,0,14,0,2,2,100,0
2,0,0,0,15,0,1,1,100,0
2,0,0,1,-11,2,2,0,0,100
2,0,0,1,-10,3,3,0,0,100
2,0,0,1,-9,5,5,0,0,100
2,0,0,1,-8,14,15,1,6.7,93.3
2,0,0,1,-7,26,26,0,0,100
2,0,0,1,-6,68,71,3,4.2,95.8
2,0,0,1,-5,144,168,24,14.3,85.7
2,0,0,1,-4,381,442,61,13.8,86.2
2,0,0,1,-3,756,978,222,22.7,77.3
2,0,0,1,-2,1584,2149,565,26.3,73.7
2,0,0,1,-1,2875,4640,1765,38,62
2,0,0,1,0,8585,17009,8424,49.5,50.5
2,0,0,1,1,1783,4404,2621,59.5,40.5
2,0,0,1,2,670,2321,1651,71.1,28.9
2,0,0,1,3,264,1134,870,76.7,23.3
2,0,0,1,4,70,523,453,86.6,13.4
2,0,0,1,5,25,188,163,86.7,13.3
2,0,0,1,6,5,72,67,93.1,6.89999999999999
2,0,0,1,7,3,32,29,90.6,9.39999999999999
2,0,0,1,8,0,13,13,100,0
2,0,0,1,9,0,8,8,100,0
2,0,0,1,10,0,5,5,100,0
2,0,0,1,11,0,1,1,100,0
2,0,0,1,13,0,1,1,100,0
2,0,0,1,14,0,1,1,100,0
2,0,0,2,-10,2,2,0,0,100
2,0,0,2,-9,1,1,0,0,100
2,0,0,2,-8,5,5,0,0,100
2,0,0,2,-7,10,10,0,0,100
2,0,0,2,-6,26,26,0,0,100
2,0,0,2,-5,64,71,7,9.9,90.1
2,0,0,2,-4,114,133,19,14.3,85.7
2,0,0,2,-3,238,312,74,23.7,76.3
2,0,0,2,-2,533,727,194,26.7,73.3
2,0,0,2,-1,990,1547,557,36,64
2,0,0,2,0,2289,4293,2004,46.7,53.3
2,0,0,2,1,499,1151,652,56.6,43.4
2,0,0,2,2,196,584,388,66.4,33.6
2,0,0,2,3,57,269,212,78.8,21.2
2,0,0,2,4,19,140,121,86.4,13.6
2,0,0,2,5,4,37,33,89.2,10.8
2,0,0,2,6,0,16,16,100,0
2,0,0,2,7,0,10,10,100,0
2,0,0,2,8,0,2,2,100,0
2,0,0,2,11,0,1,1,100,0
2,0,0,12,-10,3,3,0,0,100
2,0,0,12,-9,2,2,0,0,100
2,0,0,12,-8,9,9,0,0,100
2,0,0,12,-7,13,13,0,0,100
2,0,0,12,-6,24,25,1,4,96
2,0,0,12,-5,47,47,0,0,100
2,0,0,12,-4,109,126,17,13.5,86.5
2,0,0,12,-3,178,216,38,17.6,82.4
2,0,0,12,-2,412,554,142,25.6,74.4
2,0,0,12,-1,856,1264,408,32.3,67.7
2,0,0,12,0,2049,3678,1629,44.3,55.7
2,0,0,12,1,463,1015,552,54.4,45.6
2,0,0,12,2,186,542,356,65.7,34.3
2,0,0,12,3,74,264,190,72,28
2,0,0,12,4,26,131,105,80.2,19.8
2,0,0,12,5,6,42,36,85.7,14.3
2,0,0,12,6,0,12,12,100,0
2,0,0,12,7,3,10,7,70,30
2,0,0,12,8,0,4,4,100,0
2,0,0,12,9,0,2,2,100,0
2,0,0,12,10,0,1,1,100,0
2,0,0,3,-8,3,3,0,0,100
2,0,0,3,-7,5,5,0,0,100
2,0,0,3,-6,12,12,0,0,100
2,0,0,3,-5,11,11,0,0,100
2,0,0,3,-4,41,44,3,6.8,93.2
2,0,0,3,-3,65,79,14,17.7,82.3
2,0,0,3,-2,100,146,46,31.5,68.5
2,0,0,3,-1,204,303,99,32.7,67.3
2,0,0,3,0,329,530,201,37.9,62.1
2,0,0,3,1,69,153,84,54.9,45.1
2,0,0,3,2,34,92,58,63,37
2,0,0,3,3,6,35,29,82.9,17.1
2,0,0,3,4,3,20,17,85,15
2,0,0,3,5,0,6,6,100,0
2,0,0,3,6,0,3,3,100,0
2,0,0,13,-8,4,4,0,0,100
2,0,0,13,-7,4,4,0,0,100
2,0,0,13,-6,20,21,1,4.8,95.2
2,0,0,13,-5,38,39,1,2.6,97.4
2,0,0,13,-4,42,45,3,6.7,93.3
2,0,0,13,-3,109,140,31,22.1,77.9
2,0,0,13,-2,213,295,82,27.8,72.2
2,0,0,13,-1,399,611,212,34.7,65.3
2,0,0,13,0,741,1211,470,38.8,61.2
2,0,0,13,1,171,338,167,49.4,50.6
2,0,0,13,2,78,192,114,59.4,40.6
2,0,0,13,3,26,75,49,65.3,34.7
2,0,0,13,4,11,50,39,78,22
2,0,0,13,5,0,6,6,100,0
2,0,0,13,6,2,3,1,33.3,66.7
2,0,0,13,7,0,2,2,100,0
2,0,0,23,-8,4,4,0,0,100
2,0,0,23,-7,4,4,0,0,100
2,0,0,23,-6,9,9,0,0,100
2,0,0,23,-5,12,14,2,14.3,85.7
2,0,0,23,-4,41,49,8,16.3,83.7
2,0,0,23,-3,65,75,10,13.3,86.7
2,0,0,23,-2,152,199,47,23.6,76.4
2,0,0,23,-1,259,381,122,32,68
2,0,0,23,0,463,713,250,35.1,64.9
2,0,0,23,1,110,213,103,48.4,51.6
2,0,0,23,2,44,110,66,60,40
2,0,0,23,3,9,39,30,76.9,23.1
2,0,0,23,4,5,21,16,76.2,23.8
2,0,0,23,5,1,6,5,83.3,16.7
2,0,0,23,6,1,4,3,75,25
2,0,0,23,7,0,2,2,100,0
2,0,0,123,-9,2,2,0,0,100
2,0,0,123,-8,3,3,0,0,100
2,0,0,123,-7,5,5,0,0,100
2,0,0,123,-6,8,8,0,0,100
2,0,0,123,-5,16,17,1,5.9,94.1
2,0,0,123,-4,43,47,4,8.5,91.5
2,0,0,123,-3,68,76,8,10.5,89.5
2,0,0,123,-2,138,157,19,12.1,87.9
2,0,0,123,-1,241,319,78,24.5,75.5
2,0,0,123,0,451,712,261,36.7,63.3
2,0,0,123,1,129,231,102,44.2,55.8
2,0,0,123,2,41,109,68,62.4,37.6
2,0,0,123,3,20,48,28,58.3,41.7
2,0,0,123,4,4,23,19,82.6,17.4
2,0,0,123,5,3,9,6,66.7,33.3
2,0,0,123,6,0,4,4,100,0
2,0,0,123,7,0,2,2,100,0
2,0,0,123,8,0,1,1,100,0
2,0,1,0,-11,2,2,0,0,100
2,0,1,0,-10,10,10,0,0,100
2,0,1,0,-9,31,33,2,6.1,93.9
2,0,1,0,-8,42,44,2,4.5,95.5
2,0,1,0,-7,91,98,7,7.1,92.9
2,0,1,0,-6,189,203,14,6.9,93.1
2,0,1,0,-5,473,536,63,11.8,88.2
2,0,1,0,-4,1128,1316,188,14.3,85.7
2,0,1,0,-3,2396,3108,712,22.9,77.1
2,0,1,0,-2,4487,6682,2195,32.8,67.2
2,0,1,0,-1,7873,13743,5870,42.7,57.3
2,0,1,0,0,20926,46352,25426,54.9,45.1
2,0,1,0,1,4085,12140,8055,66.4,33.6
2,0,1,0,2,1466,6097,4631,76,24
2,0,1,0,3,506,2955,2449,82.9,17.1
2,0,1,0,4,121,1339,1218,91,9
2,0,1,0,5,41,540,499,92.4,7.59999999999999
2,0,1,0,6,12,182,170,93.4,6.59999999999999
2,0,1,0,7,1,70,69,98.6,1.40000000000001
2,0,1,0,8,0,24,24,100,0
2,0,1,0,9,1,11,10,90.9,9.09999999999999
2,0,1,0,10,0,8,8,100,0
2,0,1,0,11,0,6,6,100,0
2,0,1,0,12,0,1,1,100,0
2,0,1,0,13,0,2,2,100,0
2,0,1,0,15,0,1,1,100,0
2,0,1,1,-11,1,1,0,0,100
2,0,1,1,-10,3,3,0,0,100
2,0,1,1,-9,16,18,2,11.1,88.9
2,0,1,1,-8,20,21,1,4.8,95.2
2,0,1,1,-7,51,52,1,1.9,98.1
2,0,1,1,-6,122,128,6,4.7,95.3
2,0,1,1,-5,246,282,36,12.8,87.2
2,0,1,1,-4,555,652,97,14.9,85.1
2,0,1,1,-3,1044,1349,305,22.6,77.4
2,0,1,1,-2,1989,2879,890,30.9,69.1
2,0,1,1,-1,3586,5910,2324,39.3,60.7
2,0,1,1,0,8789,18519,9730,52.5,47.5
2,0,1,1,1,1786,4931,3145,63.8,36.2
2,0,1,1,2,658,2572,1914,74.4,25.6
2,0,1,1,3,255,1281,1026,80.1,19.9
2,0,1,1,4,60,587,527,89.8,10.2
2,0,1,1,5,29,214,185,86.4,13.6
2,0,1,1,6,8,96,88,91.7,8.3
2,0,1,1,7,1,30,29,96.7,3.3
2,0,1,1,8,0,9,9,100,0
2,0,1,1,9,0,3,3,100,0
2,0,1,1,10,0,5,5,100,0
2,0,1,1,13,0,1,1,100,0
2,0,1,1,14,0,1,1,100,0
2,0,1,2,-11,1,1,0,0,100
2,0,1,2,-10,3,3,0,0,100
2,0,1,2,-9,7,7,0,0,100
2,0,1,2,-8,14,15,1,6.7,93.3
2,0,1,2,-7,43,44,1,2.3,97.7
2,0,1,2,-6,84,88,4,4.5,95.5
2,0,1,2,-5,163,184,21,11.4,88.6
2,0,1,2,-4,327,391,64,16.4,83.6
2,0,1,2,-3,615,812,197,24.3,75.7
2,0,1,2,-2,1138,1583,445,28.1,71.9
2,0,1,2,-1,1712,2794,1082,38.7,61.3
2,0,1,2,0,3060,6212,3152,50.7,49.3
2,0,1,2,1,592,1628,1036,63.6,36.4
2,0,1,2,2,226,816,590,72.3,27.7
2,0,1,2,3,85,393,308,78.4,21.6
2,0,1,2,4,19,173,154,89,11
2,0,1,2,5,8,67,59,88.1,11.9
2,0,1,2,6,2,23,21,91.3,8.7
2,0,1,2,7,0,13,13,100,0
2,0,1,2,8,0,3,3,100,0
2,0,1,2,9,0,2,2,100,0
2,0,1,12,-12,1,1,0,0,100
2,0,1,12,-11,1,1,0,0,100
2,0,1,12,-10,6,6,0,0,100
2,0,1,12,-9,11,11,0,0,100
2,0,1,12,-8,13,13,0,0,100
2,0,1,12,-7,36,38,2,5.3,94.7
2,0,1,12,-6,63,68,5,7.4,92.6
2,0,1,12,-5,148,162,14,8.6,91.4
2,0,1,12,-4,285,338,53,15.7,84.3
2,0,1,12,-3,449,578,129,22.3,77.7
2,0,1,12,-2,800,1117,317,28.4,71.6
2,0,1,12,-1,1534,2345,811,34.6,65.4
2,0,1,12,0,2788,5505,2717,49.4,50.6
2,0,1,12,1,600,1539,939,61,39
2,0,1,12,2,233,833,600,72,28
2,0,1,12,3,86,383,297,77.5,22.5
2,0,1,12,4,35,197,162,82.2,17.8
2,0,1,12,5,13,56,43,76.8,23.2
2,0,1,12,6,2,22,20,90.9,9.09999999999999
2,0,1,12,7,2,11,9,81.8,18.2
2,0,1,12,8,0,4,4,100,0
2,0,1,12,9,0,4,4,100,0
2,0,1,12,14,0,1,1,100,0
2,0,1,3,-10,2,2,0,0,100
2,0,1,3,-9,5,5,0,0,100
2,0,1,3,-8,5,5,0,0,100
2,0,1,3,-7,6,6,0,0,100
2,0,1,3,-6,30,30,0,0,100
2,0,1,3,-5,78,84,6,7.1,92.9
2,0,1,3,-4,150,171,21,12.3,87.7
2,0,1,3,-3,229,304,75,24.7,75.3
2,0,1,3,-2,418,591,173,29.3,70.7
2,0,1,3,-1,674,1045,371,35.5,64.5
2,0,1,3,0,1004,1886,882,46.8,53.2
2,0,1,3,1,198,505,307,60.8,39.2
2,0,1,3,2,66,221,155,70.1,29.9
2,0,1,3,3,15,111,96,86.5,13.5
2,0,1,3,4,2,51,49,96.1,3.90000000000001
2,0,1,3,5,1,18,17,94.4,5.60000000000001
2,0,1,3,6,0,7,7,100,0
2,0,1,3,7,0,2,2,100,0
2,0,1,3,11,0,1,1,100,0
2,0,1,13,-10,2,2,0,0,100
2,0,1,13,-9,7,7,0,0,100
2,0,1,13,-8,10,11,1,9.1,90.9
2,0,1,13,-7,22,22,0,0,100
2,0,1,13,-6,48,49,1,2,98
2,0,1,13,-5,92,99,7,7.1,92.9
2,0,1,13,-4,147,181,34,18.8,81.2
2,0,1,13,-3,293,353,60,17,83
2,0,1,13,-2,485,648,163,25.2,74.8
2,0,1,13,-1,818,1257,439,34.9,65.1
2,0,1,13,0,1248,2265,1017,44.9,55.1
2,0,1,13,1,301,652,351,53.8,46.2
2,0,1,13,2,108,305,197,64.6,35.4
2,0,1,13,3,33,140,107,76.4,23.6
2,0,1,13,4,14,70,56,80,20
2,0,1,13,5,6,30,24,80,20
2,0,1,13,6,2,11,9,81.8,18.2
2,0,1,13,7,0,4,4,100,0
2,0,1,13,8,0,1,1,100,0
2,0,1,13,10,0,1,1,100,0
2,0,1,23,-11,1,1,0,0,100
2,0,1,23,-9,1,1,0,0,100
2,0,1,23,-8,7,8,1,12.5,87.5
2,0,1,23,-7,16,16,0,0,100
2,0,1,23,-6,27,32,5,15.6,84.4
2,0,1,23,-5,60,71,11,15.5,84.5
2,0,1,23,-4,120,142,22,15.5,84.5
2,0,1,23,-3,220,278,58,20.9,79.1
2,0,1,23,-2,427,582,155,26.6,73.4
2,0,1,23,-1,659,1000,341,34.1,65.9
2,0,1,23,0,921,1624,703,43.3,56.7
2,0,1,23,1,198,464,266,57.3,42.7
2,0,1,23,2,106,257,151,58.8,41.2
2,0,1,23,3,31,101,70,69.3,30.7
2,0,1,23,4,4,47,43,91.5,8.5
2,0,1,23,5,2,14,12,85.7,14.3
2,0,1,23,6,0,3,3,100,0
2,0,1,23,7,0,1,1,100,0
2,0,1,23,8,0,1,1,100,0
2,0,1,23,9,0,1,1,100,0
2,0,1,23,10,0,1,1,100,0
2,0,1,123,-11,3,3,0,0,100
2,0,1,123,-10,3,3,0,0,100
2,0,1,123,-9,2,2,0,0,100
2,0,1,123,-8,5,6,1,16.7,83.3
2,0,1,123,-7,15,15,0,0,100
2,0,1,123,-6,37,42,5,11.9,88.1
2,0,1,123,-5,88,99,11,11.1,88.9
2,0,1,123,-4,133,155,22,14.2,85.8
2,0,1,123,-3,221,272,51,18.8,81.2
2,0,1,123,-2,322,424,102,24.1,75.9
2,0,1,123,-1,562,839,277,33,67
2,0,1,123,0,823,1440,617,42.8,57.2
2,0,1,123,1,165,369,204,55.3,44.7
2,0,1,123,2,78,204,126,61.8,38.2
2,0,1,123,3,27,93,66,71,29
2,0,1,123,4,8,48,40,83.3,16.7
2,0,1,123,5,5,14,9,64.3,35.7
2,0,1,123,6,1,8,7,87.5,12.5
2,0,1,123,7,1,5,4,80,20
2,0,1,123,8,0,3,3,100,0
2,0,1,123,9,0,1,1,100,0
2,0,2,0,-13,1,1,0,0,100
2,0,2,0,-12,1,1,0,0,100
2,0,2,0,-11,8,8,0,0,100
2,0,2,0,-10,17,17,0,0,100
2,0,2,0,-9,34,34,0,0,100
2,0,2,0,-8,76,80,4,5,95
2,0,2,0,-7,154,162,8,4.9,95.1
2,0,2,0,-6,292,321,29,9,91
2,0,2,0,-5,527,615,88,14.3,85.7
2,0,2,0,-4,1075,1269,194,15.3,84.7
2,0,2,0,-3,2181,2881,700,24.3,75.7
2,0,2,0,-2,3942,5897,1955,33.2,66.8
2,0,2,0,-1,6691,11970,5279,44.1,55.9
2,0,2,0,0,15246,35156,19910,56.6,43.4
2,0,2,0,1,2997,9291,6294,67.7,32.3
2,0,2,0,2,1057,4659,3602,77.3,22.7
2,0,2,0,3,338,2207,1869,84.7,15.3
2,0,2,0,4,85,990,905,91.4,8.59999999999999
2,0,2,0,5,23,408,385,94.4,5.60000000000001
2,0,2,0,6,5,126,121,96,4
2,0,2,0,7,0,52,52,100,0
2,0,2,0,8,0,22,22,100,0
2,0,2,0,9,1,12,11,91.7,8.3
2,0,2,0,10,0,9,9,100,0
2,0,2,0,11,0,5,5,100,0
2,0,2,0,12,0,1,1,100,0
2,0,2,0,13,0,2,2,100,0
2,0,2,0,15,0,1,1,100,0
2,0,2,1,-12,1,1,0,0,100
2,0,2,1,-11,5,5,0,0,100
2,0,2,1,-10,12,12,0,0,100
2,0,2,1,-9,24,26,2,7.7,92.3
2,0,2,1,-8,54,55,1,1.8,98.2
2,0,2,1,-7,120,125,5,4,96
2,0,2,1,-6,216,233,17,7.3,92.7
2,0,2,1,-5,407,480,73,15.2,84.8
2,0,2,1,-4,791,952,161,16.9,83.1
2,0,2,1,-3,1413,1833,420,22.9,77.1
2,0,2,1,-2,2262,3398,1136,33.4,66.6
2,0,2,1,-1,3850,6597,2747,41.6,58.4
2,0,2,1,0,7428,16467,9039,54.9,45.1
2,0,2,1,1,1512,4491,2979,66.3,33.7
2,0,2,1,2,583,2383,1800,75.5,24.5
2,0,2,1,3,217,1217,1000,82.2,17.8
2,0,2,1,4,46,522,476,91.2,8.8
2,0,2,1,5,18,194,176,90.7,9.3
2,0,2,1,6,5,78,73,93.6,6.39999999999999
2,0,2,1,7,1,21,20,95.2,4.80000000000001
2,0,2,1,8,0,8,8,100,0
2,0,2,1,9,0,2,2,100,0
2,0,2,1,10,0,7,7,100,0
2,0,2,1,13,0,2,2,100,0
2,0,2,1,15,0,1,1,100,0
2,0,2,2,-12,2,2,0,0,100
2,0,2,2,-11,3,3,0,0,100
2,0,2,2,-10,7,7,0,0,100
2,0,2,2,-9,14,14,0,0,100
2,0,2,2,-8,24,25,1,4,96
2,0,2,2,-7,71,76,5,6.6,93.4
2,0,2,2,-6,180,193,13,6.7,93.3
2,0,2,2,-5,290,337,47,13.9,86.1
2,0,2,2,-4,597,717,120,16.7,83.3
2,0,2,2,-3,1049,1383,334,24.2,75.8
2,0,2,2,-2,1764,2549,785,30.8,69.2
2,0,2,2,-1,2407,4131,1724,41.7,58.3
2,0,2,2,0,3374,7377,4003,54.3,45.7
2,0,2,2,1,659,1968,1309,66.5,33.5
2,0,2,2,2,247,988,741,75,25
2,0,2,2,3,87,461,374,81.1,18.9
2,0,2,2,4,21,223,202,90.6,9.39999999999999
2,0,2,2,5,6,81,75,92.6,7.39999999999999
2,0,2,2,6,1,26,25,96.2,3.8
2,0,2,2,7,0,12,12,100,0
2,0,2,2,8,0,4,4,100,0
2,0,2,2,10,0,3,3,100,0
2,0,2,12,-13,1,1,0,0,100
2,0,2,12,-11,4,4,0,0,100
2,0,2,12,-10,8,8,0,0,100
2,0,2,12,-9,13,13,0,0,100
2,0,2,12,-8,26,27,1,3.7,96.3
2,0,2,12,-7,70,74,4,5.4,94.6
2,0,2,12,-6,147,159,12,7.5,92.5
2,0,2,12,-5,243,274,31,11.3,88.7
2,0,2,12,-4,460,554,94,17,83
2,0,2,12,-3,739,963,224,23.3,76.7
2,0,2,12,-2,1149,1655,506,30.6,69.4
2,0,2,12,-1,1890,3147,1257,39.9,60.1
2,0,2,12,0,2935,6157,3222,52.3,47.7
2,0,2,12,1,601,1665,1064,63.9,36.1
2,0,2,12,2,232,937,705,75.2,24.8
2,0,2,12,3,94,469,375,80,20
2,0,2,12,4,27,222,195,87.8,12.2
2,0,2,12,5,10,75,65,86.7,13.3
2,0,2,12,6,4,22,18,81.8,18.2
2,0,2,12,7,0,14,14,100,0
2,0,2,12,8,0,4,4,100,0
2,0,2,12,9,0,1,1,100,0
2,0,2,12,10,0,1,1,100,0
2,0,2,12,13,0,1,1,100,0
2,0,2,12,14,0,1,1,100,0
2,0,2,3,-12,1,1,0,0,100
2,0,2,3,-10,5,5,0,0,100
2,0,2,3,-9,5,5,0,0,100
2,0,2,3,-8,17,17,0,0,100
2,0,2,3,-7,31,32,1,3.1,96.9
2,0,2,3,-6,65,67,2,3,97
2,0,2,3,-5,134,153,19,12.4,87.6
2,0,2,3,-4,249,299,50,16.7,83.3
2,0,2,3,-3,417,565,148,26.2,73.8
2,0,2,3,-2,735,1034,299,28.9,71.1
2,0,2,3,-1,963,1685,722,42.8,57.2
2,0,2,3,0,1245,2647,1402,53,47
2,0,2,3,1,271,779,508,65.2,34.8
2,0,2,3,2,96,373,277,74.3,25.7
2,0,2,3,3,35,182,147,80.8,19.2
2,0,2,3,4,7,84,77,91.7,8.3
2,0,2,3,5,2,25,23,92,8
2,0,2,3,6,1,6,5,83.3,16.7
2,0,2,3,7,0,3,3,100,0
2,0,2,3,8,0,2,2,100,0
2,0,2,3,9,0,2,2,100,0
2,0,2,13,-12,1,1,0,0,100
2,0,2,13,-10,2,2,0,0,100
2,0,2,13,-9,12,12,0,0,100
2,0,2,13,-8,19,19,0,0,100
2,0,2,13,-7,40,42,2,4.8,95.2
2,0,2,13,-6,58,62,4,6.5,93.5
2,0,2,13,-5,136,170,34,20,80
2,0,2,13,-4,253,306,53,17.3,82.7
2,0,2,13,-3,452,588,136,23.1,76.9
2,0,2,13,-2,690,967,277,28.6,71.4
2,0,2,13,-1,997,1626,629,38.7,61.3
2,0,2,13,0,1185,2456,1271,51.8,48.2
2,0,2,13,1,294,727,433,59.6,40.4
2,0,2,13,2,100,360,260,72.2,27.8
2,0,2,13,3,34,173,139,80.3,19.7
2,0,2,13,4,5,71,66,93,7
2,0,2,13,5,3,34,31,91.2,8.8
2,0,2,13,6,1,7,6,85.7,14.3
2,0,2,13,7,0,2,2,100,0
2,0,2,13,8,0,1,1,100,0
2,0,2,13,9,0,2,2,100,0
2,0,2,23,-14,1,1,0,0,100
2,0,2,23,-13,1,1,0,0,100
2,0,2,23,-12,2,2,0,0,100
2,0,2,23,-10,3,3,0,0,100
2,0,2,23,-9,3,3,0,0,100
2,0,2,23,-8,12,12,0,0,100
2,0,2,23,-7,20,21,1,4.8,95.2
2,0,2,23,-6,42,44,2,4.5,95.5
2,0,2,23,-5,73,90,17,18.9,81.1
2,0,2,23,-4,144,174,30,17.2,82.8
2,0,2,23,-3,285,373,88,23.6,76.4
2,0,2,23,-2,557,767,210,27.4,72.6
2,0,2,23,-1,779,1237,458,37,63
2,0,2,23,0,801,1634,833,51,49
2,0,2,23,1,196,527,331,62.8,37.2
2,0,2,23,2,90,275,185,67.3,32.7
2,0,2,23,3,20,107,87,81.3,18.7
2,0,2,23,4,6,50,44,88,12
2,0,2,23,5,4,21,17,81,19
2,0,2,23,6,0,9,9,100,0
2,0,2,23,7,0,1,1,100,0
2,0,2,23,8,0,1,1,100,0
2,0,2,23,9,0,1,1,100,0
2,0,2,23,10,0,3,3,100,0
2,0,2,123,-11,2,2,0,0,100
2,0,2,123,-10,1,1,0,0,100
2,0,2,123,-9,8,8,0,0,100
2,0,2,123,-8,10,11,1,9.1,90.9
2,0,2,123,-7,19,21,2,9.5,90.5
2,0,2,123,-6,59,63,4,6.3,93.7
2,0,2,123,-5,98,116,18,15.5,84.5
2,0,2,123,-4,168,193,25,13,87
2,0,2,123,-3,260,344,84,24.4,75.6
2,0,2,123,-2,446,605,159,26.3,73.7
2,0,2,123,-1,656,1029,373,36.2,63.8
2,0,2,123,0,894,1744,850,48.7,51.3
2,0,2,123,1,172,487,315,64.7,35.3
2,0,2,123,2,96,263,167,63.5,36.5
2,0,2,123,3,28,133,105,78.9,21.1
2,0,2,123,4,7,48,41,85.4,14.6
2,0,2,123,5,5,20,15,75,25
2,0,2,123,6,2,5,3,60,40
2,0,2,123,7,0,2,2,100,0
2,0,2,123,8,0,2,2,100,0
2,1,0,0,-14,1,1,0,0,100
2,1,0,0,-13,3,3,0,0,100
2,1,0,0,-12,6,6,0,0,100
2,1,0,0,-11,10,10,0,0,100
2,1,0,0,-10,39,39,0,0,100
2,1,0,0,-9,83,85,2,2.4,97.6
2,1,0,0,-8,164,174,10,5.7,94.3
2,1,0,0,-7,361,382,21,5.5,94.5
2,1,0,0,-6,742,802,60,7.5,92.5
2,1,0,0,-5,1214,1448,234,16.2,83.8
2,1,0,0,-4,2443,2976,533,17.9,82.1
2,1,0,0,-3,4631,6216,1585,25.5,74.5
2,1,0,0,-2,8162,12314,4152,33.7,66.3
2,1,0,0,-1,13224,23779,10555,44.4,55.6
2,1,0,0,0,23547,55110,31563,57.3,42.7
2,1,0,0,1,5277,16801,11524,68.6,31.4
2,1,0,0,2,1870,8383,6513,77.7,22.3
2,1,0,0,3,613,3998,3385,84.7,15.3
2,1,0,0,4,145,1795,1650,91.9,8.09999999999999
2,1,0,0,5,49,706,657,93.1,6.89999999999999
2,1,0,0,6,8,251,243,96.8,3.2
2,1,0,0,7,4,117,113,96.6,3.40000000000001
2,1,0,0,8,0,52,52,100,0
2,1,0,0,9,1,25,24,96,4
2,1,0,0,10,0,15,15,100,0
2,1,0,0,11,0,5,5,100,0
2,1,0,0,12,0,2,2,100,0
2,1,0,0,13,0,3,3,100,0
2,1,0,0,14,0,1,1,100,0
2,1,0,0,15,0,1,1,100,0
2,1,0,1,-13,2,2,0,0,100
2,1,0,1,-12,1,1,0,0,100
2,1,0,1,-11,3,3,0,0,100
2,1,0,1,-10,8,8,0,0,100
2,1,0,1,-9,26,27,1,3.7,96.3
2,1,0,1,-8,39,42,3,7.1,92.9
2,1,0,1,-7,94,100,6,6,94
2,1,0,1,-6,190,210,20,9.5,90.5
2,1,0,1,-5,285,355,70,19.7,80.3
2,1,0,1,-4,575,745,170,22.8,77.2
2,1,0,1,-3,1094,1549,455,29.4,70.6
2,1,0,1,-2,1981,3162,1181,37.3,62.7
2,1,0,1,-1,3144,6031,2887,47.9,52.1
2,1,0,1,0,5583,14201,8618,60.7,39.3
2,1,0,1,1,1323,4416,3093,70,30
2,1,0,1,2,449,2279,1830,80.3,19.7
2,1,0,1,3,143,1023,880,86,14
2,1,0,1,4,40,479,439,91.6,8.39999999999999
2,1,0,1,5,17,211,194,91.9,8.09999999999999
2,1,0,1,6,1,81,80,98.8,1.2
2,1,0,1,7,2,45,43,95.6,4.40000000000001
2,1,0,1,8,0,16,16,100,0
2,1,0,1,9,0,8,8,100,0
2,1,0,1,10,0,4,4,100,0
2,1,0,1,11,0,4,4,100,0
2,1,0,1,13,0,1,1,100,0
2,1,0,1,15,0,1,1,100,0
2,1,0,2,-14,1,1,0,0,100
2,1,0,2,-12,1,1,0,0,100
2,1,0,2,-10,2,2,0,0,100
2,1,0,2,-9,6,7,1,14.3,85.7
2,1,0,2,-8,12,12,0,0,100
2,1,0,2,-7,16,18,2,11.1,88.9
2,1,0,2,-6,45,49,4,8.2,91.8
2,1,0,2,-5,74,84,10,11.9,88.1
2,1,0,2,-4,149,186,37,19.9,80.1
2,1,0,2,-3,259,384,125,32.6,67.4
2,1,0,2,-2,455,790,335,42.4,57.6
2,1,0,2,-1,755,1602,847,52.9,47.1
2,1,0,2,0,1361,3776,2415,64,36
2,1,0,2,1,384,1455,1071,73.6,26.4
2,1,0,2,2,146,780,634,81.3,18.7
2,1,0,2,3,40,376,336,89.4,10.6
2,1,0,2,4,12,189,177,93.7,6.3
2,1,0,2,5,3,79,76,96.2,3.8
2,1,0,2,6,4,40,36,90,10
2,1,0,2,7,0,15,15,100,0
2,1,0,2,8,0,15,15,100,0
2,1,0,2,9,0,3,3,100,0
2,1,0,2,10,0,5,5,100,0
2,1,0,2,11,0,1,1,100,0
2,1,0,2,13,0,1,1,100,0
2,1,0,12,-11,1,1,0,0,100
2,1,0,12,-10,1,1,0,0,100
2,1,0,12,-9,5,5,0,0,100
2,1,0,12,-8,15,16,1,6.2,93.8
2,1,0,12,-7,23,24,1,4.2,95.8
2,1,0,12,-6,47,53,6,11.3,88.7
2,1,0,12,-5,73,97,24,24.7,75.3
2,1,0,12,-4,141,193,52,26.9,73.1
2,1,0,12,-3,259,385,126,32.7,67.3
2,1,0,12,-2,458,787,329,41.8,58.2
2,1,0,12,-1,634,1418,784,55.3,44.7
2,1,0,12,0,1067,3136,2069,66,34
2,1,0,12,1,283,1160,877,75.6,24.4
2,1,0,12,2,92,577,485,84.1,15.9
2,1,0,12,3,27,256,229,89.5,10.5
2,1,0,12,4,5,119,114,95.8,4.2
2,1,0,12,5,2,51,49,96.1,3.90000000000001
2,1,0,12,6,0,22,22,100,0
2,1,0,12,7,0,19,19,100,0
2,1,0,12,8,0,4,4,100,0
2,1,0,12,9,0,4,4,100,0
2,1,0,12,10,0,3,3,100,0
2,1,0,12,11,0,2,2,100,0
2,1,0,3,-14,1,1,0,0,100
2,1,0,3,-10,1,1,0,0,100
2,1,0,3,-8,1,1,0,0,100
2,1,0,3,-7,2,2,0,0,100
2,1,0,3,-6,5,5,0,0,100
2,1,0,3,-5,8,12,4,33.3,66.7
2,1,0,3,-4,17,22,5,22.7,77.3
2,1,0,3,-3,39,55,16,29.1,70.9
2,1,0,3,-2,80,136,56,41.2,58.8
2,1,0,3,-1,122,237,115,48.5,51.5
2,1,0,3,0,191,529,338,63.9,36.1
2,1,0,3,1,68,334,266,79.6,20.4
2,1,0,3,2,27,187,160,85.6,14.4
2,1,0,3,3,7,84,77,91.7,8.3
2,1,0,3,4,2,49,47,95.9,4.10000000000001
2,1,0,3,5,0,18,18,100,0
2,1,0,3,6,0,13,13,100,0
2,1,0,3,7,0,3,3,100,0
2,1,0,3,8,0,4,4,100,0
2,1,0,3,9,0,1,1,100,0
2,1,0,3,11,0,1,1,100,0
2,1,0,3,12,0,2,2,100,0
2,1,0,13,-10,1,1,0,0,100
2,1,0,13,-9,1,1,0,0,100
2,1,0,13,-8,3,3,0,0,100
2,1,0,13,-7,2,4,2,50,50
2,1,0,13,-6,12,14,2,14.3,85.7
2,1,0,13,-5,18,24,6,25,75
2,1,0,13,-4,35,47,12,25.5,74.5
2,1,0,13,-3,70,113,43,38.1,61.9
2,1,0,13,-2,130,236,106,44.9,55.1
2,1,0,13,-1,200,470,270,57.4,42.6
2,1,0,13,0,368,1158,790,68.2,31.8
2,1,0,13,1,128,569,441,77.5,22.5
2,1,0,13,2,37,276,239,86.6,13.4
2,1,0,13,3,12,136,124,91.2,8.8
2,1,0,13,4,2,76,74,97.4,2.60000000000001
2,1,0,13,5,3,37,34,91.9,8.09999999999999
2,1,0,13,6,1,17,16,94.1,5.90000000000001
2,1,0,13,7,0,9,9,100,0
2,1,0,13,8,0,8,8,100,0
2,1,0,13,9,0,1,1,100,0
2,1,0,13,10,0,1,1,100,0
2,1,0,13,11,0,1,1,100,0
2,1,0,23,-11,1,1,0,0,100
2,1,0,23,-8,5,6,1,16.7,83.3
2,1,0,23,-7,6,7,1,14.3,85.7
2,1,0,23,-6,5,7,2,28.6,71.4
2,1,0,23,-5,16,17,1,5.9,94.1
2,1,0,23,-4,32,45,13,28.9,71.1
2,1,0,23,-3,49,75,26,34.7,65.3
2,1,0,23,-2,83,165,82,49.7,50.3
2,1,0,23,-1,109,322,213,66.1,33.9
2,1,0,23,0,219,712,493,69.2,30.8
2,1,0,23,1,81,345,264,76.5,23.5
2,1,0,23,2,26,184,158,85.9,14.1
2,1,0,23,3,2,78,76,97.4,2.60000000000001
2,1,0,23,4,4,49,45,91.8,8.2
2,1,0,23,5,2,19,17,89.5,10.5
2,1,0,23,6,1,11,10,90.9,9.09999999999999
2,1,0,23,7,0,6,6,100,0
2,1,0,23,8,0,4,4,100,0
2,1,0,23,9,0,3,3,100,0
2,1,0,23,10,0,1,1,100,0
2,1,0,123,-9,1,1,0,0,100
2,1,0,123,-8,2,2,0,0,100
2,1,0,123,-7,6,8,2,25,75
2,1,0,123,-6,8,12,4,33.3,66.7
2,1,0,123,-5,8,18,10,55.6,44.4
2,1,0,123,-4,24,41,17,41.5,58.5
2,1,0,123,-3,49,84,35,41.7,58.3
2,1,0,123,-2,66,163,97,59.5,40.5
2,1,0,123,-1,127,352,225,63.9,36.1
2,1,0,123,0,189,714,525,73.5,26.5
2,1,0,123,1,68,337,269,79.8,20.2
2,1,0,123,2,23,172,149,86.6,13.4
2,1,0,123,3,6,88,82,93.2,6.8
2,1,0,123,4,2,46,44,95.7,4.3
2,1,0,123,5,1,23,22,95.7,4.3
2,1,0,123,6,0,8,8,100,0
2,1,0,123,7,0,4,4,100,0
2,1,0,123,8,0,3,3,100,0
2,1,0,123,9,0,1,1,100,0
2,1,1,0,-13,1,1,0,0,100
2,1,1,0,-12,4,4,0,0,100
2,1,1,0,-11,7,7,0,0,100
2,1,1,0,-10,26,26,0,0,100
2,1,1,0,-9,50,50,0,0,100
2,1,1,0,-8,110,115,5,4.3,95.7
2,1,1,0,-7,236,246,10,4.1,95.9
2,1,1,0,-6,501,536,35,6.5,93.5
2,1,1,0,-5,854,991,137,13.8,86.2
2,1,1,0,-4,1721,2033,312,15.3,84.7
2,1,1,0,-3,3255,4221,966,22.9,77.1
2,1,1,0,-2,5707,8225,2518,30.6,69.4
2,1,1,0,-1,9433,16131,6698,41.5,58.5
2,1,1,0,0,16820,37202,20382,54.8,45.2
2,1,1,0,1,4215,12815,8600,67.1,32.9
2,1,1,0,2,1539,6476,4937,76.2,23.8
2,1,1,0,3,531,3191,2660,83.4,16.6
2,1,1,0,4,124,1434,1310,91.4,8.59999999999999
2,1,1,0,5,47,590,543,92,8
2,1,1,0,6,8,262,254,96.9,3.10000000000001
2,1,1,0,7,6,124,118,95.2,4.80000000000001
2,1,1,0,8,0,55,55,100,0
2,1,1,0,9,1,26,25,96.2,3.8
2,1,1,0,10,0,18,18,100,0
2,1,1,0,11,0,4,4,100,0
2,1,1,0,12,0,1,1,100,0
2,1,1,0,13,0,3,3,100,0
2,1,1,0,14,0,1,1,100,0
2,1,1,1,-13,2,2,0,0,100
2,1,1,1,-12,2,2,0,0,100
2,1,1,1,-11,4,4,0,0,100
2,1,1,1,-10,11,11,0,0,100
2,1,1,1,-9,28,29,1,3.4,96.6
2,1,1,1,-8,36,39,3,7.7,92.3
2,1,1,1,-7,114,119,5,4.2,95.8
2,1,1,1,-6,215,246,31,12.6,87.4
2,1,1,1,-5,339,410,71,17.3,82.7
2,1,1,1,-4,711,875,164,18.7,81.3
2,1,1,1,-3,1295,1760,465,26.4,73.6
2,1,1,1,-2,2301,3517,1216,34.6,65.4
2,1,1,1,-1,3653,6581,2928,44.5,55.5
2,1,1,1,0,6518,15224,8706,57.2,42.8
2,1,1,1,1,1763,5712,3949,69.1,30.9
2,1,1,1,2,617,2912,2295,78.8,21.2
2,1,1,1,3,227,1428,1201,84.1,15.9
2,1,1,1,4,72,712,640,89.9,10.1
2,1,1,1,5,30,342,312,91.2,8.8
2,1,1,1,6,4,165,161,97.6,2.40000000000001
2,1,1,1,7,3,66,63,95.5,4.5
2,1,1,1,8,1,31,30,96.8,3.2
2,1,1,1,9,0,16,16,100,0
2,1,1,1,10,0,5,5,100,0
2,1,1,1,11,0,5,5,100,0
2,1,1,1,12,0,1,1,100,0
2,1,1,1,13,0,2,2,100,0
2,1,1,1,14,0,1,1,100,0
2,1,1,1,15,0,1,1,100,0
2,1,1,2,-10,3,3,0,0,100
2,1,1,2,-9,4,5,1,20,80
2,1,1,2,-8,12,13,1,7.7,92.3
2,1,1,2,-7,26,30,4,13.3,86.7
2,1,1,2,-6,62,71,9,12.7,87.3
2,1,1,2,-5,103,120,17,14.2,85.8
2,1,1,2,-4,202,261,59,22.6,77.4
2,1,1,2,-3,364,539,175,32.5,67.5
2,1,1,2,-2,749,1139,390,34.2,65.8
2,1,1,2,-1,1206,2287,1081,47.3,52.7
2,1,1,2,0,2242,5624,3382,60.1,39.9
2,1,1,2,1,815,2779,1964,70.7,29.3
2,1,1,2,2,344,1650,1306,79.2,20.8
2,1,1,2,3,103,885,782,88.4,11.6
2,1,1,2,4,40,473,433,91.5,8.5
2,1,1,2,5,24,210,186,88.6,11.4
2,1,1,2,6,2,99,97,98,2
2,1,1,2,7,2,38,36,94.7,5.30000000000001
2,1,1,2,8,0,17,17,100,0
2,1,1,2,9,0,6,6,100,0
2,1,1,2,10,0,3,3,100,0
2,1,1,2,11,0,1,1,100,0
2,1,1,2,13,0,1,1,100,0
2,1,1,12,-11,1,1,0,0,100
2,1,1,12,-10,3,3,0,0,100
2,1,1,12,-9,10,10,0,0,100
2,1,1,12,-8,17,18,1,5.6,94.4
2,1,1,12,-7,44,46,2,4.3,95.7
2,1,1,12,-6,85,98,13,13.3,86.7
2,1,1,12,-5,128,159,31,19.5,80.5
2,1,1,12,-4,238,299,61,20.4,79.6
2,1,1,12,-3,401,603,202,33.5,66.5
2,1,1,12,-2,741,1160,419,36.1,63.9
2,1,1,12,-1,1031,2039,1008,49.4,50.6
2,1,1,12,0,1863,4676,2813,60.2,39.8
2,1,1,12,1,617,2246,1629,72.5,27.5
2,1,1,12,2,220,1170,950,81.2,18.8
2,1,1,12,3,96,612,516,84.3,15.7
2,1,1,12,4,25,328,303,92.4,7.59999999999999
2,1,1,12,5,11,192,181,94.3,5.7
2,1,1,12,6,5,92,87,94.6,5.40000000000001
2,1,1,12,7,1,48,47,97.9,2.10000000000001
2,1,1,12,8,0,17,17,100,0
2,1,1,12,9,1,11,10,90.9,9.09999999999999
2,1,1,12,10,0,6,6,100,0
2,1,1,12,11,0,3,3,100,0
2,1,1,12,12,0,3,3,100,0
2,1,1,12,13,0,1,1,100,0
2,1,1,3,-14,1,1,0,0,100
2,1,1,3,-12,1,1,0,0,100
2,1,1,3,-9,2,2,0,0,100
2,1,1,3,-8,3,3,0,0,100
2,1,1,3,-7,5,6,1,16.7,83.3
2,1,1,3,-6,20,21,1,4.8,95.2
2,1,1,3,-5,29,32,3,9.4,90.6
2,1,1,3,-4,70,90,20,22.2,77.8
2,1,1,3,-3,124,177,53,29.9,70.1
2,1,1,3,-2,210,353,143,40.5,59.5
2,1,1,3,-1,395,778,383,49.2,50.8
2,1,1,3,0,674,1784,1110,62.2,37.8
2,1,1,3,1,301,1126,825,73.3,26.7
2,1,1,3,2,113,629,516,82,18
2,1,1,3,3,45,362,317,87.6,12.4
2,1,1,3,4,11,190,179,94.2,5.80000000000001
2,1,1,3,5,2,105,103,98.1,1.90000000000001
2,1,1,3,6,0,27,27,100,0
2,1,1,3,7,1,18,17,94.4,5.60000000000001
2,1,1,3,8,0,8,8,100,0
2,1,1,3,9,0,3,3,100,0
2,1,1,3,10,0,3,3,100,0
2,1,1,3,11,0,1,1,100,0
2,1,1,3,12,0,1,1,100,0
2,1,1,13,-10,3,3,0,0,100
2,1,1,13,-9,2,2,0,0,100
2,1,1,13,-8,7,8,1,12.5,87.5
2,1,1,13,-7,13,15,2,13.3,86.7
2,1,1,13,-6,23,26,3,11.5,88.5
2,1,1,13,-5,38,44,6,13.6,86.4
2,1,1,13,-4,88,120,32,26.7,73.3
2,1,1,13,-3,150,218,68,31.2,68.8
2,1,1,13,-2,255,438,183,41.8,58.2
2,1,1,13,-1,441,897,456,50.8,49.2
2,1,1,13,0,733,2000,1267,63.4,36.6
2,1,1,13,1,278,1197,919,76.8,23.2
2,1,1,13,2,141,699,558,79.8,20.2
2,1,1,13,3,45,366,321,87.7,12.3
2,1,1,13,4,20,244,224,91.8,8.2
2,1,1,13,5,5,99,94,94.9,5.10000000000001
2,1,1,13,6,2,38,36,94.7,5.30000000000001
2,1,1,13,7,1,24,23,95.8,4.2
2,1,1,13,8,1,12,11,91.7,8.3
2,1,1,13,9,0,2,2,100,0
2,1,1,13,10,0,1,1,100,0
2,1,1,13,11,0,2,2,100,0
2,1,1,13,14,0,1,1,100,0
2,1,1,23,-11,1,1,0,0,100
2,1,1,23,-10,1,1,0,0,100
2,1,1,23,-9,2,3,1,33.3,66.7
2,1,1,23,-8,3,3,0,0,100
2,1,1,23,-7,5,5,0,0,100
2,1,1,23,-6,15,18,3,16.7,83.3
2,1,1,23,-5,29,33,4,12.1,87.9
2,1,1,23,-4,45,64,19,29.7,70.3
2,1,1,23,-3,101,166,65,39.2,60.8
2,1,1,23,-2,221,371,150,40.4,59.6
2,1,1,23,-1,292,674,382,56.7,43.3
2,1,1,23,0,523,1524,1001,65.7,34.3
2,1,1,23,1,245,930,685,73.7,26.3
2,1,1,23,2,94,629,535,85.1,14.9
2,1,1,23,3,41,332,291,87.7,12.3
2,1,1,23,4,9,153,144,94.1,5.90000000000001
2,1,1,23,5,3,68,65,95.6,4.40000000000001
2,1,1,23,6,1,36,35,97.2,2.8
2,1,1,23,7,0,14,14,100,0
2,1,1,23,8,0,7,7,100,0
2,1,1,23,9,0,2,2,100,0
2,1,1,23,10,0,2,2,100,0
2,1,1,23,15,0,1,1,100,0
2,1,1,123,-10,2,2,0,0,100
2,1,1,123,-9,2,2,0,0,100
2,1,1,123,-8,3,4,1,25,75
2,1,1,123,-7,7,9,2,22.2,77.8
2,1,1,123,-6,17,21,4,19,81
2,1,1,123,-5,24,36,12,33.3,66.7
2,1,1,123,-4,40,60,20,33.3,66.7
2,1,1,123,-3,94,158,64,40.5,59.5
2,1,1,123,-2,158,303,145,47.9,52.1
2,1,1,123,-1,272,616,344,55.8,44.2
2,1,1,123,0,457,1357,900,66.3,33.7
2,1,1,123,1,168,792,624,78.8,21.2
2,1,1,123,2,80,448,368,82.1,17.9
2,1,1,123,3,27,265,238,89.8,10.2
2,1,1,123,4,9,172,163,94.8,5.2
2,1,1,123,5,3,101,98,97,3
2,1,1,123,6,2,38,36,94.7,5.30000000000001
2,1,1,123,7,4,23,19,82.6,17.4
2,1,1,123,8,2,14,12,85.7,14.3
2,1,1,123,9,0,3,3,100,0
2,1,2,0,-13,2,2,0,0,100
2,1,2,0,-12,3,3,0,0,100
2,1,2,0,-11,6,6,0,0,100
2,1,2,0,-10,19,19,0,0,100
2,1,2,0,-9,39,39,0,0,100
2,1,2,0,-8,89,91,2,2.2,97.8
2,1,2,0,-7,170,175,5,2.9,97.1
2,1,2,0,-6,387,404,17,4.2,95.8
2,1,2,0,-5,643,731,88,12,88
2,1,2,0,-4,1287,1484,197,13.3,86.7
2,1,2,0,-3,2508,3187,679,21.3,78.7
2,1,2,0,-2,4417,6168,1751,28.4,71.6
2,1,2,0,-1,7425,12223,4798,39.3,60.7
2,1,2,0,0,13211,28053,14842,52.9,47.1
2,1,2,0,1,3753,10915,7162,65.6,34.4
2,1,2,0,2,1426,5685,4259,74.9,25.1
2,1,2,0,3,510,2910,2400,82.5,17.5
2,1,2,0,4,150,1408,1258,89.3,10.7
2,1,2,0,5,51,728,677,93,7
2,1,2,0,6,16,363,347,95.6,4.40000000000001
2,1,2,0,7,8,197,189,95.9,4.10000000000001
2,1,2,0,8,1,90,89,98.9,1.09999999999999
2,1,2,0,9,1,37,36,97.3,2.7
2,1,2,0,10,0,24,24,100,0
2,1,2,0,11,0,9,9,100,0
2,1,2,0,12,0,3,3,100,0
2,1,2,0,13,0,4,4,100,0
2,1,2,0,15,0,1,1,100,0
2,1,2,1,-13,1,1,0,0,100
2,1,2,1,-12,2,2,0,0,100
2,1,2,1,-11,5,5,0,0,100
2,1,2,1,-10,12,12,0,0,100
2,1,2,1,-9,20,20,0,0,100
2,1,2,1,-8,42,44,2,4.5,95.5
2,1,2,1,-7,94,98,4,4.1,95.9
2,1,2,1,-6,210,222,12,5.4,94.6
2,1,2,1,-5,318,370,52,14.1,85.9
2,1,2,1,-4,673,807,134,16.6,83.4
2,1,2,1,-3,1262,1601,339,21.2,78.8
2,1,2,1,-2,2201,3178,977,30.7,69.3
2,1,2,1,-1,3588,6042,2454,40.6,59.4
2,1,2,1,0,6226,13666,7440,54.4,45.6
2,1,2,1,1,2008,6027,4019,66.7,33.3
2,1,2,1,2,816,3411,2595,76.1,23.9
2,1,2,1,3,305,1827,1522,83.3,16.7
2,1,2,1,4,98,1048,950,90.6,9.39999999999999
2,1,2,1,5,44,508,464,91.3,8.7
2,1,2,1,6,10,260,250,96.2,3.8
2,1,2,1,7,10,137,127,92.7,7.3
2,1,2,1,8,2,72,70,97.2,2.8
2,1,2,1,9,0,25,25,100,0
2,1,2,1,10,0,12,12,100,0
2,1,2,1,11,0,6,6,100,0
2,1,2,1,12,0,4,4,100,0
2,1,2,1,13,0,4,4,100,0
2,1,2,1,15,0,1,1,100,0
2,1,2,2,-13,1,1,0,0,100
2,1,2,2,-12,1,1,0,0,100
2,1,2,2,-11,2,2,0,0,100
2,1,2,2,-10,3,3,0,0,100
2,1,2,2,-9,10,10,0,0,100
2,1,2,2,-8,14,16,2,12.5,87.5
2,1,2,2,-7,23,23,0,0,100
2,1,2,2,-6,53,62,9,14.5,85.5
2,1,2,2,-5,132,160,28,17.5,82.5
2,1,2,2,-4,273,333,60,18,82
2,1,2,2,-3,486,660,174,26.4,73.6
2,1,2,2,-2,929,1394,465,33.4,66.6
2,1,2,2,-1,1575,2804,1229,43.8,56.2
2,1,2,2,0,2900,6585,3685,56,44
2,1,2,2,1,1335,4065,2730,67.2,32.8
2,1,2,2,2,583,2494,1911,76.6,23.4
2,1,2,2,3,211,1481,1270,85.8,14.2
2,1,2,2,4,83,802,719,89.7,10.3
2,1,2,2,5,33,391,358,91.6,8.39999999999999
2,1,2,2,6,11,209,198,94.7,5.30000000000001
2,1,2,2,7,3,94,91,96.8,3.2
2,1,2,2,8,1,36,35,97.2,2.8
2,1,2,2,9,0,19,19,100,0
2,1,2,2,10,0,8,8,100,0
2,1,2,2,11,0,4,4,100,0
2,1,2,2,13,0,1,1,100,0
2,1,2,2,15,0,1,1,100,0
2,1,2,2,16,0,1,1,100,0
2,1,2,12,-12,1,1,0,0,100
2,1,2,12,-11,2,2,0,0,100
2,1,2,12,-10,2,2,0,0,100
2,1,2,12,-9,8,8,0,0,100
2,1,2,12,-8,22,22,0,0,100
2,1,2,12,-7,36,38,2,5.3,94.7
2,1,2,12,-6,95,101,6,5.9,94.1
2,1,2,12,-5,142,166,24,14.5,85.5
2,1,2,12,-4,260,311,51,16.4,83.6
2,1,2,12,-3,465,635,170,26.8,73.2
2,1,2,12,-2,869,1257,388,30.9,69.1
2,1,2,12,-1,1337,2404,1067,44.4,55.6
2,1,2,12,0,2343,5373,3030,56.4,43.6
2,1,2,12,1,946,3060,2114,69.1,30.9
2,1,2,12,2,372,1786,1414,79.2,20.8
2,1,2,12,3,159,986,827,83.9,16.1
2,1,2,12,4,47,571,524,91.8,8.2
2,1,2,12,5,28,315,287,91.1,8.89999999999999
2,1,2,12,6,7,143,136,95.1,4.90000000000001
2,1,2,12,7,4,84,80,95.2,4.80000000000001
2,1,2,12,8,1,36,35,97.2,2.8
2,1,2,12,9,1,26,25,96.2,3.8
2,1,2,12,10,0,11,11,100,0
2,1,2,12,11,0,6,6,100,0
2,1,2,12,12,0,5,5,100,0
2,1,2,12,13,0,4,4,100,0
2,1,2,3,-11,1,1,0,0,100
2,1,2,3,-9,2,3,1,33.3,66.7
2,1,2,3,-8,4,4,0,0,100
2,1,2,3,-7,10,12,2,16.7,83.3
2,1,2,3,-6,33,39,6,15.4,84.6
2,1,2,3,-5,55,62,7,11.3,88.7
2,1,2,3,-4,106,133,27,20.3,79.7
2,1,2,3,-3,190,247,57,23.1,76.9
2,1,2,3,-2,337,494,157,31.8,68.2
2,1,2,3,-1,640,1118,478,42.8,57.2
2,1,2,3,0,1090,2541,1451,57.1,42.9
2,1,2,3,1,555,1725,1170,67.8,32.2
2,1,2,3,2,225,1016,791,77.9,22.1
2,1,2,3,3,82,643,561,87.2,12.8
2,1,2,3,4,30,350,320,91.4,8.59999999999999
2,1,2,3,5,12,163,151,92.6,7.39999999999999
2,1,2,3,6,3,84,81,96.4,3.60000000000001
2,1,2,3,7,2,43,41,95.3,4.7
2,1,2,3,8,0,13,13,100,0
2,1,2,3,9,0,10,10,100,0
2,1,2,3,10,0,4,4,100,0
2,1,2,3,11,0,1,1,100,0
2,1,2,13,-10,2,2,0,0,100
2,1,2,13,-9,8,8,0,0,100
2,1,2,13,-8,6,7,1,14.3,85.7
2,1,2,13,-7,12,13,1,7.7,92.3
2,1,2,13,-6,27,29,2,6.9,93.1
2,1,2,13,-5,55,67,12,17.9,82.1
2,1,2,13,-4,103,129,26,20.2,79.8
2,1,2,13,-3,187,259,72,27.8,72.2
2,1,2,13,-2,330,528,198,37.5,62.5
2,1,2,13,-1,569,1013,444,43.8,56.2
2,1,2,13,0,982,2248,1266,56.3,43.7
2,1,2,13,1,471,1590,1119,70.4,29.6
2,1,2,13,2,190,956,766,80.1,19.9
2,1,2,13,3,81,585,504,86.2,13.8
2,1,2,13,4,33,374,341,91.2,8.8
2,1,2,13,5,8,185,177,95.7,4.3
2,1,2,13,6,4,90,86,95.6,4.40000000000001
2,1,2,13,7,1,46,45,97.8,2.2
2,1,2,13,8,1,28,27,96.4,3.60000000000001
2,1,2,13,9,0,4,4,100,0
2,1,2,13,10,0,3,3,100,0
2,1,2,13,11,0,2,2,100,0
2,1,2,13,14,0,1,1,100,0
2,1,2,23,-11,1,1,0,0,100
2,1,2,23,-9,5,5,0,0,100
2,1,2,23,-8,6,6,0,0,100
2,1,2,23,-7,12,12,0,0,100
2,1,2,23,-6,17,21,4,19,81
2,1,2,23,-5,35,39,4,10.3,89.7
2,1,2,23,-4,67,77,10,13,87
2,1,2,23,-3,134,190,56,29.5,70.5
2,1,2,23,-2,253,372,119,32,68
2,1,2,23,-1,327,632,305,48.3,51.7
2,1,2,23,0,596,1486,890,59.9,40.1
2,1,2,23,1,363,1153,790,68.5,31.5
2,1,2,23,2,143,729,586,80.4,19.6
2,1,2,23,3,50,361,311,86.1,13.9
2,1,2,23,4,12,217,205,94.5,5.5
2,1,2,23,5,3,94,91,96.8,3.2
2,1,2,23,6,3,55,52,94.5,5.5
2,1,2,23,7,0,27,27,100,0
2,1,2,23,8,0,8,8,100,0
2,1,2,23,9,0,6,6,100,0
2,1,2,23,10,0,3,3,100,0
2,1,2,23,11,0,1,1,100,0
2,1,2,23,14,0,1,1,100,0
2,1,2,23,15,0,1,1,100,0
2,1,2,123,-11,1,1,0,0,100
2,1,2,123,-9,4,4,0,0,100
2,1,2,123,-8,5,5,0,0,100
2,1,2,123,-7,10,11,1,9.1,90.9
2,1,2,123,-6,21,23,2,8.7,91.3
2,1,2,123,-5,19,29,10,34.5,65.5
2,1,2,123,-4,61,81,20,24.7,75.3
2,1,2,123,-3,139,194,55,28.4,71.6
2,1,2,123,-2,244,380,136,35.8,64.2
2,1,2,123,-1,384,710,326,45.9,54.1
2,1,2,123,0,624,1589,965,60.7,39.3
2,1,2,123,1,300,1024,724,70.7,29.3
2,1,2,123,2,140,692,552,79.8,20.2
2,1,2,123,3,57,425,368,86.6,13.4
2,1,2,123,4,18,244,226,92.6,7.39999999999999
2,1,2,123,5,10,134,124,92.5,7.5
2,1,2,123,6,2,77,75,97.4,2.60000000000001
2,1,2,123,7,2,35,33,94.3,5.7
2,1,2,123,8,1,13,12,92.3,7.69999999999999
2,1,2,123,9,0,8,8,100,0
2,1,2,123,10,0,2,2,100,0
2,1,2,123,12,0,2,2,100,0
2,1,2,123,13,0,1,1,100,0
3,0,0,0,-13,3,3,0,0,100
3,0,0,0,-12,9,9,0,0,100
3,0,0,0,-11,11,11,0,0,100
3,0,0,0,-10,38,38,0,0,100
3,0,0,0,-9,80,81,1,1.2,98.8
3,0,0,0,-8,149,154,5,3.2,96.8
3,0,0,0,-7,329,338,9,2.7,97.3
3,0,0,0,-6,717,760,43,5.7,94.3
3,0,0,0,-5,1218,1392,174,12.5,87.5
3,0,0,0,-4,2447,2808,361,12.9,87.1
3,0,0,0,-3,4320,5474,1154,21.1,78.9
3,0,0,0,-2,7606,10652,3046,28.6,71.4
3,0,0,0,-1,12436,20373,7937,39,61
3,0,0,0,0,21459,45040,23581,52.4,47.6
3,0,0,0,1,7645,21759,14114,64.9,35.1
3,0,0,0,2,2921,11731,8810,75.1,24.9
3,0,0,0,3,1095,6222,5127,82.4,17.6
3,0,0,0,4,351,3215,2864,89.1,10.9
3,0,0,0,5,141,1712,1571,91.8,8.2
3,0,0,0,6,41,883,842,95.4,4.60000000000001
3,0,0,0,7,18,438,420,95.9,4.10000000000001
3,0,0,0,8,8,220,212,96.4,3.60000000000001
3,0,0,0,9,2,94,92,97.9,2.10000000000001
3,0,0,0,10,0,46,46,100,0
3,0,0,0,11,0,22,22,100,0
3,0,0,0,12,0,8,8,100,0
3,0,0,0,13,0,8,8,100,0
3,0,0,0,14,0,2,2,100,0
3,0,0,0,15,0,3,3,100,0
3,0,0,0,16,0,1,1,100,0
3,0,0,1,-13,1,1,0,0,100
3,0,0,1,-12,2,2,0,0,100
3,0,0,1,-11,7,7,0,0,100
3,0,0,1,-10,14,14,0,0,100
3,0,0,1,-9,26,26,0,0,100
3,0,0,1,-8,36,37,1,2.7,97.3
3,0,0,1,-7,91,94,3,3.2,96.8
3,0,0,1,-6,205,217,12,5.5,94.5
3,0,0,1,-5,325,367,42,11.4,88.6
3,0,0,1,-4,690,794,104,13.1,86.9
3,0,0,1,-3,1219,1468,249,17,83
3,0,0,1,-2,2095,2802,707,25.2,74.8
3,0,0,1,-1,3294,5142,1848,35.9,64.1
3,0,0,1,0,5503,10563,5060,47.9,52.1
3,0,0,1,1,1983,5027,3044,60.6,39.4
3,0,0,1,2,791,2720,1929,70.9,29.1
3,0,0,1,3,286,1517,1231,81.1,18.9
3,0,0,1,4,112,734,622,84.7,15.3
3,0,0,1,5,44,436,392,89.9,10.1
3,0,0,1,6,12,195,183,93.8,6.2
3,0,0,1,7,6,105,99,94.3,5.7
3,0,0,1,8,2,64,62,96.9,3.10000000000001
3,0,0,1,9,0,22,22,100,0
3,0,0,1,10,0,7,7,100,0
3,0,0,1,11,0,6,6,100,0
3,0,0,1,13,0,3,3,100,0
3,0,0,1,15,0,1,1,100,0
3,0,0,1,16,0,1,1,100,0
3,0,0,2,-10,2,2,0,0,100
3,0,0,2,-9,5,6,1,16.7,83.3
3,0,0,2,-8,17,18,1,5.6,94.4
3,0,0,2,-7,33,34,1,2.9,97.1
3,0,0,2,-6,78,81,3,3.7,96.3
3,0,0,2,-5,132,150,18,12,88
3,0,0,2,-4,239,273,34,12.5,87.5
3,0,0,2,-3,454,565,111,19.6,80.4
3,0,0,2,-2,770,1004,234,23.3,76.7
3,0,0,2,-1,1067,1577,510,32.3,67.7
3,0,0,2,0,1473,2686,1213,45.2,54.8
3,0,0,2,1,565,1287,722,56.1,43.9
3,0,0,2,2,208,674,466,69.1,30.9
3,0,0,2,3,80,365,285,78.1,21.9
3,0,0,2,4,31,176,145,82.4,17.6
3,0,0,2,5,14,98,84,85.7,14.3
3,0,0,2,6,2,52,50,96.2,3.8
3,0,0,2,7,1,13,12,92.3,7.69999999999999
3,0,0,2,8,1,7,6,85.7,14.3
3,0,0,2,9,0,5,5,100,0
3,0,0,2,10,0,3,3,100,0
3,0,0,2,11,0,1,1,100,0
3,0,0,2,13,0,1,1,100,0
3,0,0,12,-11,1,1,0,0,100
3,0,0,12,-10,4,4,0,0,100
3,0,0,12,-9,6,6,0,0,100
3,0,0,12,-8,12,13,1,7.7,92.3
3,0,0,12,-7,34,35,1,2.9,97.1
3,0,0,12,-6,65,66,1,1.5,98.5
3,0,0,12,-5,120,129,9,7,93
3,0,0,12,-4,205,239,34,14.2,85.8
3,0,0,12,-3,350,416,66,15.9,84.1
3,0,0,12,-2,595,758,163,21.5,78.5
3,0,0,12,-1,807,1215,408,33.6,66.4
3,0,0,12,0,1092,1866,774,41.5,58.5
3,0,0,12,1,451,987,536,54.3,45.7
3,0,0,12,2,205,572,367,64.2,35.8
3,0,0,12,3,80,317,237,74.8,25.2
3,0,0,12,4,36,169,133,78.7,21.3
3,0,0,12,5,15,106,91,85.8,14.2
3,0,0,12,6,6,51,45,88.2,11.8
3,0,0,12,7,3,31,28,90.3,9.7
3,0,0,12,8,1,15,14,93.3,6.69999999999999
3,0,0,12,9,0,1,1,100,0
3,0,0,12,10,0,3,3,100,0
3,0,0,3,-10,1,1,0,0,100
3,0,0,3,-9,1,1,0,0,100
3,0,0,3,-8,5,5,0,0,100
3,0,0,3,-7,9,9,0,0,100
3,0,0,3,-6,14,14,0,0,100
3,0,0,3,-5,35,37,2,5.4,94.6
3,0,0,3,-4,58,60,2,3.3,96.7
3,0,0,3,-3,109,122,13,10.7,89.3
3,0,0,3,-2,169,207,38,18.4,81.6
3,0,0,3,-1,231,325,94,28.9,71.1
3,0,0,3,0,253,432,179,41.4,58.6
3,0,0,3,1,103,219,116,53,47
3,0,0,3,2,32,111,79,71.2,28.8
3,0,0,3,3,15,55,40,72.7,27.3
3,0,0,3,4,6,22,16,72.7,27.3
3,0,0,3,5,0,8,8,100,0
3,0,0,3,6,1,4,3,75,25
3,0,0,3,7,0,4,4,100,0
3,0,0,3,8,0,2,2,100,0
3,0,0,3,9,0,2,2,100,0
3,0,0,13,-9,2,2,0,0,100
3,0,0,13,-8,6,6,0,0,100
3,0,0,13,-7,14,14,0,0,100
3,0,0,13,-6,25,25,0,0,100
3,0,0,13,-5,50,52,2,3.8,96.2
3,0,0,13,-4,90,96,6,6.2,93.8
3,0,0,13,-3,207,244,37,15.2,84.8
3,0,0,13,-2,286,362,76,21,79
3,0,0,13,-1,388,545,157,28.8,71.2
3,0,0,13,0,505,805,300,37.3,62.7
3,0,0,13,1,179,358,179,50,50
3,0,0,13,2,68,189,121,64,36
3,0,0,13,3,22,91,69,75.8,24.2
3,0,0,13,4,15,64,49,76.6,23.4
3,0,0,13,5,3,22,19,86.4,13.6
3,0,0,13,6,2,14,12,85.7,14.3
3,0,0,13,7,1,4,3,75,25
3,0,0,13,8,1,6,5,83.3,16.7
3,0,0,13,9,0,2,2,100,0
3,0,0,13,13,0,1,1,100,0
3,0,0,23,-12,1,1,0,0,100
3,0,0,23,-10,2,2,0,0,100
3,0,0,23,-9,2,2,0,0,100
3,0,0,23,-8,3,3,0,0,100
3,0,0,23,-7,5,5,0,0,100
3,0,0,23,-6,21,22,1,4.5,95.5
3,0,0,23,-5,29,30,1,3.3,96.7
3,0,0,23,-4,65,73,8,11,89
3,0,0,23,-3,112,128,16,12.5,87.5
3,0,0,23,-2,196,231,35,15.2,84.8
3,0,0,23,-1,232,300,68,22.7,77.3
3,0,0,23,0,261,422,161,38.2,61.8
3,0,0,23,1,110,224,114,50.9,49.1
3,0,0,23,2,50,121,71,58.7,41.3
3,0,0,23,3,13,49,36,73.5,26.5
3,0,0,23,4,7,28,21,75,25
3,0,0,23,5,4,21,17,81,19
3,0,0,23,6,2,6,4,66.7,33.3
3,0,0,23,7,0,6,6,100,0
3,0,0,23,8,0,4,4,100,0
3,0,0,23,9,0,1,1,100,0
3,0,0,23,10,0,1,1,100,0
3,0,0,23,16,0,1,1,100,0
3,0,0,123,-11,1,1,0,0,100
3,0,0,123,-10,2,2,0,0,100
3,0,0,123,-8,4,5,1,20,80
3,0,0,123,-7,8,9,1,11.1,88.9
3,0,0,123,-6,14,14,0,0,100
3,0,0,123,-5,43,46,3,6.5,93.5
3,0,0,123,-4,70,77,7,9.1,90.9
3,0,0,123,-3,111,127,16,12.6,87.4
3,0,0,123,-2,182,216,34,15.7,84.3
3,0,0,123,-1,243,328,85,25.9,74.1
3,0,0,123,0,280,400,120,30,70
3,0,0,123,1,114,201,87,43.3,56.7
3,0,0,123,2,54,115,61,53,47
3,0,0,123,3,21,68,47,69.1,30.9
3,0,0,123,4,6,30,24,80,20
3,0,0,123,5,1,19,18,94.7,5.30000000000001
3,0,0,123,6,2,12,10,83.3,16.7
3,0,0,123,7,0,11,11,100,0
3,0,0,123,8,1,6,5,83.3,16.7
3,0,0,123,9,0,1,1,100,0
3,0,0,123,10,0,1,1,100,0
3,0,1,0,-14,1,1,0,0,100
3,0,1,0,-13,3,3,0,0,100
3,0,1,0,-12,8,8,0,0,100
3,0,1,0,-11,10,10,0,0,100
3,0,1,0,-10,30,30,0,0,100
3,0,1,0,-9,62,63,1,1.6,98.4
3,0,1,0,-8,141,146,5,3.4,96.6
3,0,1,0,-7,275,282,7,2.5,97.5
3,0,1,0,-6,617,656,39,5.9,94.1
3,0,1,0,-5,1106,1258,152,12.1,87.9
3,0,1,0,-4,2050,2390,340,14.2,85.8
3,0,1,0,-3,3391,4391,1000,22.8,77.2
3,0,1,0,-2,5573,8066,2493,30.9,69.1
3,0,1,0,-1,8851,15032,6181,41.1,58.9
3,0,1,0,0,14815,32598,17783,54.6,45.4
3,0,1,0,1,5182,15770,10588,67.1,32.9
3,0,1,0,2,1911,8423,6512,77.3,22.7
3,0,1,0,3,726,4399,3673,83.5,16.5
3,0,1,0,4,212,2308,2096,90.8,9.2
3,0,1,0,5,83,1182,1099,93,7
3,0,1,0,6,25,633,608,96.1,3.90000000000001
3,0,1,0,7,13,318,305,95.9,4.10000000000001
3,0,1,0,8,6,150,144,96,4
3,0,1,0,9,2,64,62,96.9,3.10000000000001
3,0,1,0,10,0,37,37,100,0
3,0,1,0,11,0,15,15,100,0
3,0,1,0,12,0,7,7,100,0
3,0,1,0,13,0,5,5,100,0
3,0,1,0,14,0,2,2,100,0
3,0,1,0,15,0,2,2,100,0
3,0,1,1,-14,1,1,0,0,100
3,0,1,1,-13,1,1,0,0,100
3,0,1,1,-12,6,6,0,0,100
3,0,1,1,-11,8,8,0,0,100
3,0,1,1,-10,15,15,0,0,100
3,0,1,1,-9,33,35,2,5.7,94.3
3,0,1,1,-8,62,62,0,0,100
3,0,1,1,-7,143,152,9,5.9,94.1
3,0,1,1,-6,302,326,24,7.4,92.6
3,0,1,1,-5,507,573,66,11.5,88.5
3,0,1,1,-4,992,1150,158,13.7,86.3
3,0,1,1,-3,1587,1969,382,19.4,80.6
3,0,1,1,-2,2697,3803,1106,29.1,70.9
3,0,1,1,-1,3933,6440,2507,38.9,61.1
3,0,1,1,0,5686,11748,6062,51.6,48.4
3,0,1,1,1,2134,5842,3708,63.5,36.5
3,0,1,1,2,765,3179,2414,75.9,24.1
3,0,1,1,3,363,1799,1436,79.8,20.2
3,0,1,1,4,108,870,762,87.6,12.4
3,0,1,1,5,45,510,465,91.2,8.8
3,0,1,1,6,13,258,245,95,5
3,0,1,1,7,5,131,126,96.2,3.8
3,0,1,1,8,1,65,64,98.5,1.5
3,0,1,1,9,1,26,25,96.2,3.8
3,0,1,1,10,0,9,9,100,0
3,0,1,1,11,0,11,11,100,0
3,0,1,1,12,0,2,2,100,0
3,0,1,1,13,0,2,2,100,0
3,0,1,1,14,0,1,1,100,0
3,0,1,1,15,0,1,1,100,0
3,0,1,2,-12,1,1,0,0,100
3,0,1,2,-11,5,5,0,0,100
3,0,1,2,-10,7,7,0,0,100
3,0,1,2,-9,12,13,1,7.7,92.3
3,0,1,2,-8,36,38,2,5.3,94.7
3,0,1,2,-7,56,59,3,5.1,94.9
3,0,1,2,-6,157,167,10,6,94
3,0,1,2,-5,248,285,37,13,87
3,0,1,2,-4,509,582,73,12.5,87.5
3,0,1,2,-3,839,1032,193,18.7,81.3
3,0,1,2,-2,1355,1859,504,27.1,72.9
3,0,1,2,-1,2019,3158,1139,36.1,63.9
3,0,1,2,0,2863,5612,2749,49,51
3,0,1,2,1,973,2622,1649,62.9,37.1
3,0,1,2,2,326,1195,869,72.7,27.3
3,0,1,2,3,127,619,492,79.5,20.5
3,0,1,2,4,33,303,270,89.1,10.9
3,0,1,2,5,9,149,140,94,6
3,0,1,2,6,6,82,76,92.7,7.3
3,0,1,2,7,0,37,37,100,0
3,0,1,2,8,1,20,19,95,5
3,0,1,2,9,0,8,8,100,0
3,0,1,2,10,0,5,5,100,0
3,0,1,2,11,0,1,1,100,0
3,0,1,2,15,0,1,1,100,0
3,0,1,12,-14,1,1,0,0,100
3,0,1,12,-13,1,1,0,0,100
3,0,1,12,-12,3,4,1,25,75
3,0,1,12,-11,5,6,1,16.7,83.3
3,0,1,12,-10,6,6,0,0,100
3,0,1,12,-9,17,18,1,5.6,94.4
3,0,1,12,-8,34,35,1,2.9,97.1
3,0,1,12,-7,82,84,2,2.4,97.6
3,0,1,12,-6,133,142,9,6.3,93.7
3,0,1,12,-5,235,255,20,7.8,92.2
3,0,1,12,-4,431,508,77,15.2,84.8
3,0,1,12,-3,682,841,159,18.9,81.1
3,0,1,12,-2,1104,1508,404,26.8,73.2
3,0,1,12,-1,1488,2317,829,35.8,64.2
3,0,1,12,0,1708,3314,1606,48.5,51.5
3,0,1,12,1,696,1685,989,58.7,41.3
3,0,1,12,2,297,999,702,70.3,29.7
3,0,1,12,3,127,548,421,76.8,23.2
3,0,1,12,4,56,289,233,80.6,19.4
3,0,1,12,5,16,173,157,90.8,9.2
3,0,1,12,6,5,86,81,94.2,5.80000000000001
3,0,1,12,7,4,44,40,90.9,9.09999999999999
3,0,1,12,8,0,20,20,100,0
3,0,1,12,9,0,10,10,100,0
3,0,1,12,10,0,3,3,100,0
3,0,1,12,11,0,3,3,100,0
3,0,1,12,12,0,2,2,100,0
3,0,1,12,14,0,1,1,100,0
3,0,1,3,-11,3,3,0,0,100
3,0,1,3,-10,1,1,0,0,100
3,0,1,3,-9,3,3,0,0,100
3,0,1,3,-8,14,15,1,6.7,93.3
3,0,1,3,-7,29,30,1,3.3,96.7
3,0,1,3,-6,53,61,8,13.1,86.9
3,0,1,3,-5,104,116,12,10.3,89.7
3,0,1,3,-4,198,227,29,12.8,87.2
3,0,1,3,-3,364,443,79,17.8,82.2
3,0,1,3,-2,526,688,162,23.5,76.5
3,0,1,3,-1,806,1225,419,34.2,65.8
3,0,1,3,0,879,1649,770,46.7,53.3
3,0,1,3,1,302,739,437,59.1,40.9
3,0,1,3,2,109,381,272,71.4,28.6
3,0,1,3,3,51,187,136,72.7,27.3
3,0,1,3,4,17,90,73,81.1,18.9
3,0,1,3,5,3,29,26,89.7,10.3
3,0,1,3,6,1,29,28,96.6,3.40000000000001
3,0,1,3,7,0,8,8,100,0
3,0,1,3,8,0,6,6,100,0
3,0,1,3,9,0,6,6,100,0
3,0,1,3,10,0,1,1,100,0
3,0,1,3,15,0,1,1,100,0
3,0,1,13,-15,1,1,0,0,100
3,0,1,13,-13,1,1,0,0,100
3,0,1,13,-11,3,3,0,0,100
3,0,1,13,-10,4,4,0,0,100
3,0,1,13,-9,13,14,1,7.1,92.9
3,0,1,13,-8,25,25,0,0,100
3,0,1,13,-7,31,32,1,3.1,96.9
3,0,1,13,-6,59,62,3,4.8,95.2
3,0,1,13,-5,114,123,9,7.3,92.7
3,0,1,13,-4,246,282,36,12.8,87.2
3,0,1,13,-3,409,500,91,18.2,81.8
3,0,1,13,-2,632,842,210,24.9,75.1
3,0,1,13,-1,880,1290,410,31.8,68.2
3,0,1,13,0,909,1564,655,41.9,58.1
3,0,1,13,1,343,824,481,58.4,41.6
3,0,1,13,2,142,444,302,68,32
3,0,1,13,3,66,239,173,72.4,27.6
3,0,1,13,4,21,113,92,81.4,18.6
3,0,1,13,5,9,60,51,85,15
3,0,1,13,6,3,36,33,91.7,8.3
3,0,1,13,7,0,9,9,100,0
3,0,1,13,8,0,6,6,100,0
3,0,1,13,9,0,3,3,100,0
3,0,1,13,10,0,1,1,100,0
3,0,1,13,11,0,1,1,100,0
3,0,1,13,13,0,1,1,100,0
3,0,1,23,-15,1,1,0,0,100
3,0,1,23,-12,1,1,0,0,100
3,0,1,23,-11,4,4,0,0,100
3,0,1,23,-10,4,4,0,0,100
3,0,1,23,-9,8,9,1,11.1,88.9
3,0,1,23,-8,10,10,0,0,100
3,0,1,23,-7,19,20,1,5,95
3,0,1,23,-6,60,63,3,4.8,95.2
3,0,1,23,-5,98,110,12,10.9,89.1
3,0,1,23,-4,191,219,28,12.8,87.2
3,0,1,23,-3,295,345,50,14.5,85.5
3,0,1,23,-2,443,562,119,21.2,78.8
3,0,1,23,-1,597,891,294,33,67
3,0,1,23,0,680,1202,522,43.4,56.6
3,0,1,23,1,271,616,345,56,44
3,0,1,23,2,98,294,196,66.7,33.3
3,0,1,23,3,52,163,111,68.1,31.9
3,0,1,23,4,13,69,56,81.2,18.8
3,0,1,23,5,7,42,35,83.3,16.7
3,0,1,23,6,0,18,18,100,0
3,0,1,23,7,1,14,13,92.9,7.09999999999999
3,0,1,23,8,1,6,5,83.3,16.7
3,0,1,23,9,0,1,1,100,0
3,0,1,23,10,0,1,1,100,0
3,0,1,23,11,0,1,1,100,0
3,0,1,123,-13,1,1,0,0,100
3,0,1,123,-12,1,1,0,0,100
3,0,1,123,-11,6,6,0,0,100
3,0,1,123,-10,7,7,0,0,100
3,0,1,123,-9,8,9,1,11.1,88.9
3,0,1,123,-8,7,7,0,0,100
3,0,1,123,-7,24,25,1,4,96
3,0,1,123,-6,48,50,2,4,96
3,0,1,123,-5,106,116,10,8.6,91.4
3,0,1,123,-4,233,265,32,12.1,87.9
3,0,1,123,-3,319,374,55,14.7,85.3
3,0,1,123,-2,509,648,139,21.5,78.5
3,0,1,123,-1,589,862,273,31.7,68.3
3,0,1,123,0,577,979,402,41.1,58.9
3,0,1,123,1,215,469,254,54.2,45.8
3,0,1,123,2,85,248,163,65.7,34.3
3,0,1,123,3,43,141,98,69.5,30.5
3,0,1,123,4,10,69,59,85.5,14.5
3,0,1,123,5,7,46,39,84.8,15.2
3,0,1,123,6,1,22,21,95.5,4.5
3,0,1,123,7,0,10,10,100,0
3,0,1,123,8,1,11,10,90.9,9.09999999999999
3,0,1,123,9,0,2,2,100,0
3,0,1,123,10,0,1,1,100,0
3,0,2,0,-13,7,7,0,0,100
3,0,2,0,-12,8,8,0,0,100
3,0,2,0,-11,18,18,0,0,100
3,0,2,0,-10,40,40,0,0,100
3,0,2,0,-9,74,76,2,2.6,97.4
3,0,2,0,-8,151,156,5,3.2,96.8
3,0,2,0,-7,289,299,10,3.3,96.7
3,0,2,0,-6,627,669,42,6.3,93.7
3,0,2,0,-5,1084,1238,154,12.4,87.6
3,0,2,0,-4,2018,2393,375,15.7,84.3
3,0,2,0,-3,3160,4147,987,23.8,76.2
3,0,2,0,-2,4725,6948,2223,32,68
3,0,2,0,-1,6950,12200,5250,43,57
3,0,2,0,0,11172,25403,14231,56,44
3,0,2,0,1,3762,12147,8385,69,31
3,0,2,0,2,1447,6563,5116,78,22
3,0,2,0,3,484,3406,2922,85.8,14.2
3,0,2,0,4,140,1758,1618,92,8
3,0,2,0,5,61,921,860,93.4,6.59999999999999
3,0,2,0,6,12,464,452,97.4,2.60000000000001
3,0,2,0,7,11,230,219,95.2,4.80000000000001
3,0,2,0,8,3,112,109,97.3,2.7
3,0,2,0,9,0,47,47,100,0
3,0,2,0,10,0,29,29,100,0
3,0,2,0,11,0,7,7,100,0
3,0,2,0,12,0,5,5,100,0
3,0,2,0,13,0,5,5,100,0
3,0,2,0,14,0,2,2,100,0
3,0,2,0,15,0,1,1,100,0
3,0,2,1,-15,1,1,0,0,100
3,0,2,1,-14,1,1,0,0,100
3,0,2,1,-13,3,3,0,0,100
3,0,2,1,-12,5,5,0,0,100
3,0,2,1,-11,10,11,1,9.1,90.9
3,0,2,1,-10,22,23,1,4.3,95.7
3,0,2,1,-9,59,60,1,1.7,98.3
3,0,2,1,-8,107,110,3,2.7,97.3
3,0,2,1,-7,221,230,9,3.9,96.1
3,0,2,1,-6,379,412,33,8,92
3,0,2,1,-5,711,811,100,12.3,87.7
3,0,2,1,-4,1219,1452,233,16,84
3,0,2,1,-3,1891,2449,558,22.8,77.2
3,0,2,1,-2,2994,4340,1346,31,69
3,0,2,1,-1,4042,6964,2922,42,58
3,0,2,1,0,5138,11353,6215,54.7,45.3
3,0,2,1,1,1827,5528,3701,67,33
3,0,2,1,2,699,3064,2365,77.2,22.8
3,0,2,1,3,260,1666,1406,84.4,15.6
3,0,2,1,4,83,836,753,90.1,9.89999999999999
3,0,2,1,5,39,464,425,91.6,8.39999999999999
3,0,2,1,6,10,255,245,96.1,3.90000000000001
3,0,2,1,7,7,137,130,94.9,5.10000000000001
3,0,2,1,8,2,56,54,96.4,3.60000000000001
3,0,2,1,9,0,32,32,100,0
3,0,2,1,10,0,9,9,100,0
3,0,2,1,11,0,5,5,100,0
3,0,2,1,12,0,2,2,100,0
3,0,2,1,13,0,2,2,100,0
3,0,2,1,15,0,1,1,100,0
3,0,2,2,-18,1,1,0,0,100
3,0,2,2,-15,1,1,0,0,100
3,0,2,2,-14,2,2,0,0,100
3,0,2,2,-13,4,4,0,0,100
3,0,2,2,-12,8,8,0,0,100
3,0,2,2,-11,9,9,0,0,100
3,0,2,2,-10,21,21,0,0,100
3,0,2,2,-9,25,27,2,7.4,92.6
3,0,2,2,-8,54,55,1,1.8,98.2
3,0,2,2,-7,120,127,7,5.5,94.5
3,0,2,2,-6,286,305,19,6.2,93.8
3,0,2,2,-5,423,485,62,12.8,87.2
3,0,2,2,-4,808,928,120,12.9,87.1
3,0,2,2,-3,1183,1508,325,21.6,78.4
3,0,2,2,-2,1836,2601,765,29.4,70.6
3,0,2,2,-1,2368,4072,1704,41.8,58.2
3,0,2,2,0,3059,6560,3501,53.4,46.6
3,0,2,2,1,1122,3182,2060,64.7,35.3
3,0,2,2,2,374,1482,1108,74.8,25.2
3,0,2,2,3,153,819,666,81.3,18.7
3,0,2,2,4,27,364,337,92.6,7.39999999999999
3,0,2,2,5,14,198,184,92.9,7.09999999999999
3,0,2,2,6,7,91,84,92.3,7.69999999999999
3,0,2,2,7,1,48,47,97.9,2.10000000000001
3,0,2,2,8,1,17,16,94.1,5.90000000000001
3,0,2,2,9,0,13,13,100,0
3,0,2,2,10,0,8,8,100,0
3,0,2,2,11,0,3,3,100,0
3,0,2,2,12,0,2,2,100,0
3,0,2,2,13,0,1,1,100,0
3,0,2,2,14,0,1,1,100,0
3,0,2,2,15,0,1,1,100,0
3,0,2,12,-16,1,1,0,0,100
3,0,2,12,-14,1,1,0,0,100
3,0,2,12,-12,6,7,1,14.3,85.7
3,0,2,12,-11,6,6,0,0,100
3,0,2,12,-10,12,12,0,0,100
3,0,2,12,-9,35,37,2,5.4,94.6
3,0,2,12,-8,75,78,3,3.8,96.2
3,0,2,12,-7,127,131,4,3.1,96.9
3,0,2,12,-6,229,246,17,6.9,93.1
3,0,2,12,-5,388,437,49,11.2,88.8
3,0,2,12,-4,697,812,115,14.2,85.8
3,0,2,12,-3,1051,1298,247,19,81
3,0,2,12,-2,1485,2107,622,29.5,70.5
3,0,2,12,-1,1796,3118,1322,42.4,57.6
3,0,2,12,0,1949,4077,2128,52.2,47.8
3,0,2,12,1,746,2040,1294,63.4,36.6
3,0,2,12,2,290,1145,855,74.7,25.3
3,0,2,12,3,126,672,546,81.2,18.8
3,0,2,12,4,35,328,293,89.3,10.7
3,0,2,12,5,20,189,169,89.4,10.6
3,0,2,12,6,6,105,99,94.3,5.7
3,0,2,12,7,2,58,56,96.6,3.40000000000001
3,0,2,12,8,1,17,16,94.1,5.90000000000001
3,0,2,12,9,0,13,13,100,0
3,0,2,12,10,0,6,6,100,0
3,0,2,12,11,0,3,3,100,0
3,0,2,12,12,0,3,3,100,0
3,0,2,12,15,0,1,1,100,0
3,0,2,3,-16,1,1,0,0,100
3,0,2,3,-15,1,1,0,0,100
3,0,2,3,-12,2,2,0,0,100
3,0,2,3,-11,2,2,0,0,100
3,0,2,3,-10,5,6,1,16.7,83.3
3,0,2,3,-9,12,12,0,0,100
3,0,2,3,-8,33,34,1,2.9,97.1
3,0,2,3,-7,63,65,2,3.1,96.9
3,0,2,3,-6,92,102,10,9.8,90.2
3,0,2,3,-5,186,210,24,11.4,88.6
3,0,2,3,-4,325,371,46,12.4,87.6
3,0,2,3,-3,511,658,147,22.3,77.7
3,0,2,3,-2,763,1082,319,29.5,70.5
3,0,2,3,-1,1098,1802,704,39.1,60.9
3,0,2,3,0,1158,2490,1332,53.5,46.5
3,0,2,3,1,391,1152,761,66.1,33.9
3,0,2,3,2,151,566,415,73.3,26.7
3,0,2,3,3,48,281,233,82.9,17.1
3,0,2,3,4,15,128,113,88.3,11.7
3,0,2,3,5,6,68,62,91.2,8.8
3,0,2,3,6,1,35,34,97.1,2.90000000000001
3,0,2,3,7,0,19,19,100,0
3,0,2,3,8,1,9,8,88.9,11.1
3,0,2,3,9,0,2,2,100,0
3,0,2,3,10,0,3,3,100,0
3,0,2,3,11,0,1,1,100,0
3,0,2,13,-16,1,1,0,0,100
3,0,2,13,-15,2,2,0,0,100
3,0,2,13,-13,2,2,0,0,100
3,0,2,13,-11,6,6,0,0,100
3,0,2,13,-10,8,8,0,0,100
3,0,2,13,-9,15,15,0,0,100
3,0,2,13,-8,36,36,0,0,100
3,0,2,13,-7,74,79,5,6.3,93.7
3,0,2,13,-6,102,107,5,4.7,95.3
3,0,2,13,-5,230,248,18,7.3,92.7
3,0,2,13,-4,354,410,56,13.7,86.3
3,0,2,13,-3,548,701,153,21.8,78.2
3,0,2,13,-2,811,1141,330,28.9,71.1
3,0,2,13,-1,1005,1628,623,38.3,61.7
3,0,2,13,0,988,2020,1032,51.1,48.9
3,0,2,13,1,342,955,613,64.2,35.8
3,0,2,13,2,139,510,371,72.7,27.3
3,0,2,13,3,46,253,207,81.8,18.2
3,0,2,13,4,22,152,130,85.5,14.5
3,0,2,13,5,7,78,71,91,9
3,0,2,13,6,3,50,47,94,6
3,0,2,13,7,2,26,24,92.3,7.69999999999999
3,0,2,13,8,0,4,4,100,0
3,0,2,13,9,0,6,6,100,0
3,0,2,13,10,0,1,1,100,0
3,0,2,13,12,0,1,1,100,0
3,0,2,13,13,0,1,1,100,0
3,0,2,23,-16,1,1,0,0,100
3,0,2,23,-12,3,3,0,0,100
3,0,2,23,-11,7,7,0,0,100
3,0,2,23,-10,6,7,1,14.3,85.7
3,0,2,23,-9,11,12,1,8.3,91.7
3,0,2,23,-8,21,21,0,0,100
3,0,2,23,-7,42,44,2,4.5,95.5
3,0,2,23,-6,111,114,3,2.6,97.4
3,0,2,23,-5,142,157,15,9.6,90.4
3,0,2,23,-4,221,272,51,18.8,81.2
3,0,2,23,-3,321,402,81,20.1,79.9
3,0,2,23,-2,464,664,200,30.1,69.9
3,0,2,23,-1,540,882,342,38.8,61.2
3,0,2,23,0,535,1123,588,52.4,47.6
3,0,2,23,1,216,567,351,61.9,38.1
3,0,2,23,2,87,296,209,70.6,29.4
3,0,2,23,3,40,164,124,75.6,24.4
3,0,2,23,4,13,74,61,82.4,17.6
3,0,2,23,5,3,42,39,92.9,7.09999999999999
3,0,2,23,6,2,27,25,92.6,7.39999999999999
3,0,2,23,7,1,19,18,94.7,5.30000000000001
3,0,2,23,8,0,5,5,100,0
3,0,2,23,9,0,2,2,100,0
3,0,2,23,10,0,1,1,100,0
3,0,2,23,11,0,2,2,100,0
3,0,2,23,14,0,1,1,100,0
3,0,2,123,-13,1,1,0,0,100
3,0,2,123,-12,2,2,0,0,100
3,0,2,123,-11,6,6,0,0,100
3,0,2,123,-10,5,5,0,0,100
3,0,2,123,-9,11,11,0,0,100
3,0,2,123,-8,24,24,0,0,100
3,0,2,123,-7,48,49,1,2,98
3,0,2,123,-6,81,82,1,1.2,98.8
3,0,2,123,-5,153,172,19,11,89
3,0,2,123,-4,294,342,48,14,86
3,0,2,123,-3,369,448,79,17.6,82.4
3,0,2,123,-2,580,801,221,27.6,72.4
3,0,2,123,-1,616,1022,406,39.7,60.3
3,0,2,123,0,616,1201,585,48.7,51.3
3,0,2,123,1,250,616,366,59.4,40.6
3,0,2,123,2,92,314,222,70.7,29.3
3,0,2,123,3,33,173,140,80.9,19.1
3,0,2,123,4,15,92,77,83.7,16.3
3,0,2,123,5,9,43,34,79.1,20.9
3,0,2,123,6,0,14,14,100,0
3,0,2,123,7,1,19,18,94.7,5.30000000000001
3,0,2,123,8,1,7,6,85.7,14.3
3,0,2,123,9,0,2,2,100,0
3,0,2,123,10,0,2,2,100,0
3,0,2,123,11,0,1,1,100,0
3,1,0,0,-18,1,1,0,0,100
3,1,0,0,-16,1,1,0,0,100
3,1,0,0,-15,1,1,0,0,100
3,1,0,0,-14,2,2,0,0,100
3,1,0,0,-13,14,14,0,0,100
3,1,0,0,-12,22,23,1,4.3,95.7
3,1,0,0,-11,43,44,1,2.3,97.7
3,1,0,0,-10,84,87,3,3.4,96.6
3,1,0,0,-9,167,172,5,2.9,97.1
3,1,0,0,-8,344,350,6,1.7,98.3
3,1,0,0,-7,674,705,31,4.4,95.6
3,1,0,0,-6,1333,1438,105,7.3,92.7
3,1,0,0,-5,2330,2663,333,12.5,87.5
3,1,0,0,-4,4096,4895,799,16.3,83.7
3,1,0,0,-3,6244,8230,1986,24.1,75.9
3,1,0,0,-2,9062,13554,4492,33.1,66.9
3,1,0,0,-1,12103,21887,9784,44.7,55.3
3,1,0,0,0,16255,38050,21795,57.3,42.7
3,1,0,0,1,5755,19093,13338,69.9,30.1
3,1,0,0,2,2132,10476,8344,79.6,20.4
3,1,0,0,3,794,5730,4936,86.1,13.9
3,1,0,0,4,228,3054,2826,92.5,7.5
3,1,0,0,5,115,1692,1577,93.2,6.8
3,1,0,0,6,26,888,862,97.1,2.90000000000001
3,1,0,0,7,8,420,412,98.1,1.90000000000001
3,1,0,0,8,3,194,191,98.5,1.5
3,1,0,0,9,0,90,90,100,0
3,1,0,0,10,1,42,41,97.6,2.40000000000001
3,1,0,0,11,0,22,22,100,0
3,1,0,0,12,0,4,4,100,0
3,1,0,0,13,0,8,8,100,0
3,1,0,0,14,0,3,3,100,0
3,1,0,0,15,0,3,3,100,0
3,1,0,0,16,0,1,1,100,0
3,1,0,0,17,0,1,1,100,0
3,1,0,1,-14,1,1,0,0,100
3,1,0,1,-13,1,1,0,0,100
3,1,0,1,-12,3,3,0,0,100
3,1,0,1,-11,7,7,0,0,100
3,1,0,1,-10,13,14,1,7.1,92.9
3,1,0,1,-9,39,43,4,9.3,90.7
3,1,0,1,-8,69,70,1,1.4,98.6
3,1,0,1,-7,179,191,12,6.3,93.7
3,1,0,1,-6,296,329,33,10,90
3,1,0,1,-5,552,669,117,17.5,82.5
3,1,0,1,-4,978,1237,259,20.9,79.1
3,1,0,1,-3,1479,2063,584,28.3,71.7
3,1,0,1,-2,2088,3388,1300,38.4,61.6
3,1,0,1,-1,2716,5379,2663,49.5,50.5
3,1,0,1,0,3519,9271,5752,62,38
3,1,0,1,1,1301,4918,3617,73.5,26.5
3,1,0,1,2,520,2921,2401,82.2,17.8
3,1,0,1,3,212,1628,1416,87,13
3,1,0,1,4,55,852,797,93.5,6.5
3,1,0,1,5,30,466,436,93.6,6.39999999999999
3,1,0,1,6,7,233,226,97,3
3,1,0,1,7,0,115,115,100,0
3,1,0,1,8,1,50,49,98,2
3,1,0,1,9,0,27,27,100,0
3,1,0,1,10,1,14,13,92.9,7.09999999999999
3,1,0,1,11,0,6,6,100,0
3,1,0,1,12,0,2,2,100,0
3,1,0,1,13,0,2,2,100,0
3,1,0,1,14,0,1,1,100,0
3,1,0,1,15,0,2,2,100,0
3,1,0,2,-11,1,1,0,0,100
3,1,0,2,-10,2,3,1,33.3,66.7
3,1,0,2,-9,10,10,0,0,100
3,1,0,2,-8,17,19,2,10.5,89.5
3,1,0,2,-7,31,32,1,3.1,96.9
3,1,0,2,-6,73,82,9,11,89
3,1,0,2,-5,119,151,32,21.2,78.8
3,1,0,2,-4,233,299,66,22.1,77.9
3,1,0,2,-3,328,468,140,29.9,70.1
3,1,0,2,-2,522,880,358,40.7,59.3
3,1,0,2,-1,660,1456,796,54.7,45.3
3,1,0,2,0,841,2409,1568,65.1,34.9
3,1,0,2,1,352,1521,1169,76.9,23.1
3,1,0,2,2,167,1014,847,83.5,16.5
3,1,0,2,3,74,637,563,88.4,11.6
3,1,0,2,4,18,323,305,94.4,5.60000000000001
3,1,0,2,5,9,181,172,95,5
3,1,0,2,6,5,72,67,93.1,6.89999999999999
3,1,0,2,7,1,41,40,97.6,2.40000000000001
3,1,0,2,8,0,13,13,100,0
3,1,0,2,9,0,13,13,100,0
3,1,0,2,10,0,5,5,100,0
3,1,0,2,11,0,2,2,100,0
3,1,0,2,12,0,1,1,100,0
3,1,0,2,13,0,1,1,100,0
3,1,0,12,-11,1,1,0,0,100
3,1,0,12,-10,2,2,0,0,100
3,1,0,12,-9,11,11,0,0,100
3,1,0,12,-8,17,17,0,0,100
3,1,0,12,-7,40,45,5,11.1,88.9
3,1,0,12,-6,66,73,7,9.6,90.4
3,1,0,12,-5,123,165,42,25.5,74.5
3,1,0,12,-4,239,321,82,25.5,74.5
3,1,0,12,-3,325,489,164,33.5,66.5
3,1,0,12,-2,430,771,341,44.2,55.8
3,1,0,12,-1,449,1054,605,57.4,42.6
3,1,0,12,0,573,1788,1215,68,32
3,1,0,12,1,259,1166,907,77.8,22.2
3,1,0,12,2,115,775,660,85.2,14.8
3,1,0,12,3,55,479,424,88.5,11.5
3,1,0,12,4,17,257,240,93.4,6.59999999999999
3,1,0,12,5,2,156,154,98.7,1.3
3,1,0,12,6,1,73,72,98.6,1.40000000000001
3,1,0,12,7,2,36,34,94.4,5.60000000000001
3,1,0,12,8,0,17,17,100,0
3,1,0,12,9,0,9,9,100,0
3,1,0,12,10,1,8,7,87.5,12.5
3,1,0,12,11,0,1,1,100,0
3,1,0,3,-10,1,1,0,0,100
3,1,0,3,-8,5,7,2,28.6,71.4
3,1,0,3,-7,14,14,0,0,100
3,1,0,3,-6,12,15,3,20,80
3,1,0,3,-5,21,26,5,19.2,80.8
3,1,0,3,-4,41,57,16,28.1,71.9
3,1,0,3,-3,63,95,32,33.7,66.3
3,1,0,3,-2,101,162,61,37.7,62.3
3,1,0,3,-1,135,306,171,55.9,44.1
3,1,0,3,0,147,477,330,69.2,30.8
3,1,0,3,1,89,348,259,74.4,25.6
3,1,0,3,2,31,269,238,88.5,11.5
3,1,0,3,3,14,143,129,90.2,9.8
3,1,0,3,4,8,68,60,88.2,11.8
3,1,0,3,5,1,32,31,96.9,3.10000000000001
3,1,0,3,6,1,25,24,96,4
3,1,0,3,7,0,12,12,100,0
3,1,0,3,8,0,4,4,100,0
3,1,0,3,9,0,1,1,100,0
3,1,0,3,10,0,1,1,100,0
3,1,0,3,11,0,2,2,100,0
3,1,0,3,12,0,1,1,100,0
3,1,0,13,-11,1,1,0,0,100
3,1,0,13,-10,1,1,0,0,100
3,1,0,13,-9,1,1,0,0,100
3,1,0,13,-8,2,3,1,33.3,66.7
3,1,0,13,-7,9,9,0,0,100
3,1,0,13,-6,15,18,3,16.7,83.3
3,1,0,13,-5,37,50,13,26,74
3,1,0,13,-4,82,106,24,22.6,77.4
3,1,0,13,-3,100,154,54,35.1,64.9
3,1,0,13,-2,147,301,154,51.2,48.8
3,1,0,13,-1,177,443,266,60,40
3,1,0,13,0,184,728,544,74.7,25.3
3,1,0,13,1,112,578,466,80.6,19.4
3,1,0,13,2,60,414,354,85.5,14.5
3,1,0,13,3,16,220,204,92.7,7.3
3,1,0,13,4,4,107,103,96.3,3.7
3,1,0,13,5,3,56,53,94.6,5.40000000000001
3,1,0,13,6,2,25,23,92,8
3,1,0,13,7,0,10,10,100,0
3,1,0,13,8,0,6,6,100,0
3,1,0,13,9,0,3,3,100,0
3,1,0,13,10,0,1,1,100,0
3,1,0,13,11,1,1,0,0,100
3,1,0,13,12,0,1,1,100,0
3,1,0,23,-8,3,3,0,0,100
3,1,0,23,-7,3,3,0,0,100
3,1,0,23,-6,10,13,3,23.1,76.9
3,1,0,23,-5,20,26,6,23.1,76.9
3,1,0,23,-4,41,56,15,26.8,73.2
3,1,0,23,-3,58,90,32,35.6,64.4
3,1,0,23,-2,81,175,94,53.7,46.3
3,1,0,23,-1,77,233,156,67,33
3,1,0,23,0,88,395,307,77.7,22.3
3,1,0,23,1,57,355,298,83.9,16.1
3,1,0,23,2,29,253,224,88.5,11.5
3,1,0,23,3,14,173,159,91.9,8.09999999999999
3,1,0,23,4,6,88,82,93.2,6.8
3,1,0,23,5,1,46,45,97.8,2.2
3,1,0,23,6,1,25,24,96,4
3,1,0,23,7,0,14,14,100,0
3,1,0,23,8,0,2,2,100,0
3,1,0,23,9,0,4,4,100,0
3,1,0,23,10,0,1,1,100,0
3,1,0,23,11,0,2,2,100,0
3,1,0,123,-11,1,1,0,0,100
3,1,0,123,-10,1,1,0,0,100
3,1,0,123,-9,5,5,0,0,100
3,1,0,123,-8,3,3,0,0,100
3,1,0,123,-7,2,3,1,33.3,66.7
3,1,0,123,-6,14,16,2,12.5,87.5
3,1,0,123,-5,22,30,8,26.7,73.3
3,1,0,123,-4,44,76,32,42.1,57.9
3,1,0,123,-3,56,105,49,46.7,53.3
3,1,0,123,-2,72,176,104,59.1,40.9
3,1,0,123,-1,87,250,163,65.2,34.8
3,1,0,123,0,86,386,300,77.7,22.3
3,1,0,123,1,67,351,284,80.9,19.1
3,1,0,123,2,29,243,214,88.1,11.9
3,1,0,123,3,14,171,157,91.8,8.2
3,1,0,123,4,4,87,83,95.4,4.60000000000001
3,1,0,123,5,1,58,57,98.3,1.7
3,1,0,123,6,0,32,32,100,0
3,1,0,123,7,0,10,10,100,0
3,1,0,123,8,0,5,5,100,0
3,1,0,123,9,0,2,2,100,0
3,1,0,123,10,0,1,1,100,0
3,1,0,123,11,0,1,1,100,0
3,1,1,0,-18,1,1,0,0,100
3,1,1,0,-16,1,1,0,0,100
3,1,1,0,-15,1,1,0,0,100
3,1,1,0,-14,1,1,0,0,100
3,1,1,0,-13,13,13,0,0,100
3,1,1,0,-12,19,20,1,5,95
3,1,1,0,-11,37,38,1,2.6,97.4
3,1,1,0,-10,69,70,1,1.4,98.6
3,1,1,0,-9,119,121,2,1.7,98.3
3,1,1,0,-8,260,265,5,1.9,98.1
3,1,1,0,-7,457,476,19,4,96
3,1,1,0,-6,963,1025,62,6,94
3,1,1,0,-5,1664,1844,180,9.8,90.2
3,1,1,0,-4,2917,3383,466,13.8,86.2
3,1,1,0,-3,4517,5786,1269,21.9,78.1
3,1,1,0,-2,6646,9531,2885,30.3,69.7
3,1,1,0,-1,9024,15561,6537,42,58
3,1,1,0,0,12381,27343,14962,54.7,45.3
3,1,1,0,1,4559,13968,9409,67.4,32.6
3,1,1,0,2,1729,7836,6107,77.9,22.1
3,1,1,0,3,659,4466,3807,85.2,14.8
3,1,1,0,4,201,2483,2282,91.9,8.09999999999999
3,1,1,0,5,99,1440,1341,93.1,6.89999999999999
3,1,1,0,6,27,777,750,96.5,3.5
3,1,1,0,7,9,361,352,97.5,2.5
3,1,1,0,8,2,184,182,98.9,1.09999999999999
3,1,1,0,9,0,69,69,100,0
3,1,1,0,10,0,34,34,100,0
3,1,1,0,11,0,23,23,100,0
3,1,1,0,12,0,6,6,100,0
3,1,1,0,13,0,7,7,100,0
3,1,1,0,14,0,2,2,100,0
3,1,1,0,16,0,1,1,100,0
3,1,1,0,17,0,1,1,100,0
3,1,1,0,18,0,1,1,100,0
3,1,1,1,-18,1,1,0,0,100
3,1,1,1,-14,1,1,0,0,100
3,1,1,1,-13,4,4,0,0,100
3,1,1,1,-12,7,7,0,0,100
3,1,1,1,-11,17,18,1,5.6,94.4
3,1,1,1,-10,23,25,2,8,92
3,1,1,1,-9,41,44,3,6.8,93.2
3,1,1,1,-8,96,97,1,1,99
3,1,1,1,-7,195,204,9,4.4,95.6
3,1,1,1,-6,384,415,31,7.5,92.5
3,1,1,1,-5,690,783,93,11.9,88.1
3,1,1,1,-4,1110,1343,233,17.3,82.7
3,1,1,1,-3,1764,2360,596,25.3,74.7
3,1,1,1,-2,2509,3805,1296,34.1,65.9
3,1,1,1,-1,3311,6058,2747,45.3,54.7
3,1,1,1,0,4290,10340,6050,58.5,41.5
3,1,1,1,1,1700,6016,4316,71.7,28.3
3,1,1,1,2,736,3673,2937,80,20
3,1,1,1,3,308,2193,1885,86,14
3,1,1,1,4,87,1170,1083,92.6,7.39999999999999
3,1,1,1,5,45,683,638,93.4,6.59999999999999
3,1,1,1,6,10,332,322,97,3
3,1,1,1,7,2,166,164,98.8,1.2
3,1,1,1,8,1,86,85,98.8,1.2
3,1,1,1,9,0,49,49,100,0
3,1,1,1,10,0,16,16,100,0
3,1,1,1,11,0,15,15,100,0
3,1,1,1,12,0,7,7,100,0
3,1,1,1,13,0,5,5,100,0
3,1,1,1,14,0,3,3,100,0
3,1,1,1,15,0,1,1,100,0
3,1,1,1,18,0,1,1,100,0
3,1,1,2,-12,3,3,0,0,100
3,1,1,2,-11,1,1,0,0,100
3,1,1,2,-10,9,10,1,10,90
3,1,1,2,-9,11,11,0,0,100
3,1,1,2,-8,23,25,2,8,92
3,1,1,2,-7,67,69,2,2.9,97.1
3,1,1,2,-6,139,156,17,10.9,89.1
3,1,1,2,-5,209,243,34,14,86
3,1,1,2,-4,422,527,105,19.9,80.1
3,1,1,2,-3,637,871,234,26.9,73.1
3,1,1,2,-2,1009,1561,552,35.4,64.6
3,1,1,2,-1,1496,2815,1319,46.9,53.1
3,1,1,2,0,2002,5099,3097,60.7,39.3
3,1,1,2,1,863,3117,2254,72.3,27.7
3,1,1,2,2,381,1893,1512,79.9,20.1
3,1,1,2,3,160,1166,1006,86.3,13.7
3,1,1,2,4,52,657,605,92.1,7.89999999999999
3,1,1,2,5,35,362,327,90.3,9.7
3,1,1,2,6,7,178,171,96.1,3.90000000000001
3,1,1,2,7,2,97,95,97.9,2.10000000000001
3,1,1,2,8,1,43,42,97.7,2.3
3,1,1,2,9,0,16,16,100,0
3,1,1,2,10,0,11,11,100,0
3,1,1,2,11,0,7,7,100,0
3,1,1,2,12,0,1,1,100,0
3,1,1,2,13,0,3,3,100,0
3,1,1,2,15,0,1,1,100,0
3,1,1,12,-13,2,2,0,0,100
3,1,1,12,-12,4,4,0,0,100
3,1,1,12,-11,7,7,0,0,100
3,1,1,12,-10,5,5,0,0,100
3,1,1,12,-9,13,13,0,0,100
3,1,1,12,-8,34,34,0,0,100
3,1,1,12,-7,64,70,6,8.6,91.4
3,1,1,12,-6,106,121,15,12.4,87.6
3,1,1,12,-5,214,265,51,19.2,80.8
3,1,1,12,-4,387,494,107,21.7,78.3
3,1,1,12,-3,526,756,230,30.4,69.6
3,1,1,12,-2,767,1252,485,38.7,61.3
3,1,1,12,-1,915,1902,987,51.9,48.1
3,1,1,12,0,1149,3127,1978,63.3,36.7
3,1,1,12,1,577,2258,1681,74.4,25.6
3,1,1,12,2,261,1473,1212,82.3,17.7
3,1,1,12,3,125,977,852,87.2,12.8
3,1,1,12,4,33,577,544,94.3,5.7
3,1,1,12,5,11,304,293,96.4,3.60000000000001
3,1,1,12,6,3,166,163,98.2,1.8
3,1,1,12,7,1,53,52,98.1,1.90000000000001
3,1,1,12,8,1,34,33,97.1,2.90000000000001
3,1,1,12,9,0,26,26,100,0
3,1,1,12,10,0,11,11,100,0
3,1,1,12,11,0,5,5,100,0
3,1,1,12,12,0,2,2,100,0
3,1,1,12,13,0,4,4,100,0
3,1,1,12,14,0,2,2,100,0
3,1,1,3,-10,1,1,0,0,100
3,1,1,3,-9,4,4,0,0,100
3,1,1,3,-8,21,22,1,4.5,95.5
3,1,1,3,-7,21,22,1,4.5,95.5
3,1,1,3,-6,42,44,2,4.5,95.5
3,1,1,3,-5,56,72,16,22.2,77.8
3,1,1,3,-4,109,142,33,23.2,76.8
3,1,1,3,-3,192,274,82,29.9,70.1
3,1,1,3,-2,326,535,209,39.1,60.9
3,1,1,3,-1,413,859,446,51.9,48.1
3,1,1,3,0,547,1577,1030,65.3,34.7
3,1,1,3,1,302,1132,830,73.3,26.7
3,1,1,3,2,139,809,670,82.8,17.2
3,1,1,3,3,59,479,420,87.7,12.3
3,1,1,3,4,21,249,228,91.6,8.39999999999999
3,1,1,3,5,5,128,123,96.1,3.90000000000001
3,1,1,3,6,5,73,68,93.2,6.8
3,1,1,3,7,0,27,27,100,0
3,1,1,3,8,0,15,15,100,0
3,1,1,3,9,0,3,3,100,0
3,1,1,3,10,0,5,5,100,0
3,1,1,3,11,0,3,3,100,0
3,1,1,3,12,0,1,1,100,0
3,1,1,13,-12,1,1,0,0,100
3,1,1,13,-11,2,2,0,0,100
3,1,1,13,-10,2,2,0,0,100
3,1,1,13,-9,6,7,1,14.3,85.7
3,1,1,13,-8,10,11,1,9.1,90.9
3,1,1,13,-7,28,29,1,3.4,96.6
3,1,1,13,-6,53,58,5,8.6,91.4
3,1,1,13,-5,55,71,16,22.5,77.5
3,1,1,13,-4,149,200,51,25.5,74.5
3,1,1,13,-3,265,359,94,26.2,73.8
3,1,1,13,-2,312,544,232,42.6,57.4
3,1,1,13,-1,384,905,521,57.6,42.4
3,1,1,13,0,512,1605,1093,68.1,31.9
3,1,1,13,1,288,1274,986,77.4,22.6
3,1,1,13,2,133,867,734,84.7,15.3
3,1,1,13,3,60,514,454,88.3,11.7
3,1,1,13,4,20,282,262,92.9,7.09999999999999
3,1,1,13,5,9,167,158,94.6,5.40000000000001
3,1,1,13,6,4,70,66,94.3,5.7
3,1,1,13,7,0,35,35,100,0
3,1,1,13,8,0,17,17,100,0
3,1,1,13,9,0,10,10,100,0
3,1,1,13,10,1,4,3,75,25
3,1,1,13,11,1,6,5,83.3,16.7
3,1,1,13,12,0,1,1,100,0
3,1,1,23,-12,1,1,0,0,100
3,1,1,23,-11,2,2,0,0,100
3,1,1,23,-10,2,2,0,0,100
3,1,1,23,-9,5,5,0,0,100
3,1,1,23,-8,7,7,0,0,100
3,1,1,23,-7,17,18,1,5.6,94.4
3,1,1,23,-6,29,37,8,21.6,78.4
3,1,1,23,-5,40,51,11,21.6,78.4
3,1,1,23,-4,97,136,39,28.7,71.3
3,1,1,23,-3,157,240,83,34.6,65.4
3,1,1,23,-2,229,422,193,45.7,54.3
3,1,1,23,-1,276,643,367,57.1,42.9
3,1,1,23,0,411,1205,794,65.9,34.1
3,1,1,23,1,166,850,684,80.5,19.5
3,1,1,23,2,79,601,522,86.9,13.1
3,1,1,23,3,30,386,356,92.2,7.8
3,1,1,23,4,18,223,205,91.9,8.09999999999999
3,1,1,23,5,6,122,116,95.1,4.90000000000001
3,1,1,23,6,1,66,65,98.5,1.5
3,1,1,23,7,1,49,48,98,2
3,1,1,23,8,0,15,15,100,0
3,1,1,23,9,0,9,9,100,0
3,1,1,23,10,0,8,8,100,0
3,1,1,23,11,0,5,5,100,0
3,1,1,23,13,0,1,1,100,0
3,1,1,23,14,0,1,1,100,0
3,1,1,23,18,0,1,1,100,0
3,1,1,123,-10,2,2,0,0,100
3,1,1,123,-9,7,7,0,0,100
3,1,1,123,-8,4,4,0,0,100
3,1,1,123,-7,12,13,1,7.7,92.3
3,1,1,123,-6,25,30,5,16.7,83.3
3,1,1,123,-5,54,65,11,16.9,83.1
3,1,1,123,-4,104,151,47,31.1,68.9
3,1,1,123,-3,125,199,74,37.2,62.8
3,1,1,123,-2,182,341,159,46.6,53.4
3,1,1,123,-1,234,568,334,58.8,41.2
3,1,1,123,0,320,1029,709,68.9,31.1
3,1,1,123,1,185,870,685,78.7,21.3
3,1,1,123,2,96,668,572,85.6,14.4
3,1,1,123,3,49,453,404,89.2,10.8
3,1,1,123,4,12,253,241,95.3,4.7
3,1,1,123,5,4,155,151,97.4,2.60000000000001
3,1,1,123,6,1,70,69,98.6,1.40000000000001
3,1,1,123,7,1,43,42,97.7,2.3
3,1,1,123,8,1,18,17,94.4,5.60000000000001
3,1,1,123,9,0,10,10,100,0
3,1,1,123,10,0,4,4,100,0
3,1,1,123,11,0,1,1,100,0
3,1,1,123,12,0,1,1,100,0
3,1,1,123,13,0,1,1,100,0
3,1,1,123,14,0,1,1,100,0
3,1,2,0,-16,1,1,0,0,100
3,1,2,0,-15,1,1,0,0,100
3,1,2,0,-14,1,1,0,0,100
3,1,2,0,-13,10,10,0,0,100
3,1,2,0,-12,9,10,1,10,90
3,1,2,0,-11,24,24,0,0,100
3,1,2,0,-10,50,50,0,0,100
3,1,2,0,-9,95,96,1,1,99
3,1,2,0,-8,184,188,4,2.1,97.9
3,1,2,0,-7,357,370,13,3.5,96.5
3,1,2,0,-6,713,751,38,5.1,94.9
3,1,2,0,-5,1251,1376,125,9.1,90.9
3,1,2,0,-4,2264,2582,318,12.3,87.7
3,1,2,0,-3,3492,4400,908,20.6,79.4
3,1,2,0,-2,5239,7321,2082,28.4,71.6
3,1,2,0,-1,7184,12049,4865,40.4,59.6
3,1,2,0,0,9968,21056,11088,52.7,47.3
3,1,2,0,1,3897,11331,7434,65.6,34.4
3,1,2,0,2,1560,6745,5185,76.9,23.1
3,1,2,0,3,648,4176,3528,84.5,15.5
3,1,2,0,4,224,2483,2259,91,9
3,1,2,0,5,100,1411,1311,92.9,7.09999999999999
3,1,2,0,6,29,760,731,96.2,3.8
3,1,2,0,7,10,365,355,97.3,2.7
3,1,2,0,8,2,186,184,98.9,1.09999999999999
3,1,2,0,9,0,87,87,100,0
3,1,2,0,10,0,45,45,100,0
3,1,2,0,11,0,29,29,100,0
3,1,2,0,12,0,10,10,100,0
3,1,2,0,13,0,7,7,100,0
3,1,2,0,14,0,2,2,100,0
3,1,2,0,15,0,1,1,100,0
3,1,2,0,16,0,1,1,100,0
3,1,2,0,17,0,1,1,100,0
3,1,2,1,-18,1,1,0,0,100
3,1,2,1,-13,6,6,0,0,100
3,1,2,1,-12,7,8,1,12.5,87.5
3,1,2,1,-11,12,13,1,7.7,92.3
3,1,2,1,-10,25,26,1,3.8,96.2
3,1,2,1,-9,46,47,1,2.1,97.9
3,1,2,1,-8,81,82,1,1.2,98.8
3,1,2,1,-7,214,223,9,4,96
3,1,2,1,-6,386,407,21,5.2,94.8
3,1,2,1,-5,712,775,63,8.1,91.9
3,1,2,1,-4,1151,1336,185,13.8,86.2
3,1,2,1,-3,1797,2307,510,22.1,77.9
3,1,2,1,-2,2498,3612,1114,30.8,69.2
3,1,2,1,-1,3334,5749,2415,42,58
3,1,2,1,0,4462,9838,5376,54.6,45.4
3,1,2,1,1,2134,6504,4370,67.2,32.8
3,1,2,1,2,902,4160,3258,78.3,21.7
3,1,2,1,3,417,2619,2202,84.1,15.9
3,1,2,1,4,128,1549,1421,91.7,8.3
3,1,2,1,5,56,880,824,93.6,6.39999999999999
3,1,2,1,6,21,455,434,95.4,4.60000000000001
3,1,2,1,7,6,266,260,97.7,2.3
3,1,2,1,8,2,122,120,98.4,1.59999999999999
3,1,2,1,9,1,68,67,98.5,1.5
3,1,2,1,10,0,27,27,100,0
3,1,2,1,11,0,16,16,100,0
3,1,2,1,12,0,11,11,100,0
3,1,2,1,13,0,6,6,100,0
3,1,2,1,14,0,3,3,100,0
3,1,2,1,15,0,1,1,100,0
3,1,2,1,16,0,1,1,100,0
3,1,2,2,-16,1,1,0,0,100
3,1,2,2,-13,1,1,0,0,100
3,1,2,2,-12,3,3,0,0,100
3,1,2,2,-11,2,2,0,0,100
3,1,2,2,-10,8,8,0,0,100
3,1,2,2,-9,17,17,0,0,100
3,1,2,2,-8,33,35,2,5.7,94.3
3,1,2,2,-7,82,87,5,5.7,94.3
3,1,2,2,-6,147,165,18,10.9,89.1
3,1,2,2,-5,285,327,42,12.8,87.2
3,1,2,2,-4,504,582,78,13.4,86.6
3,1,2,2,-3,805,1054,249,23.6,76.4
3,1,2,2,-2,1323,1873,550,29.4,70.6
3,1,2,2,-1,1946,3372,1426,42.3,57.7
3,1,2,2,0,2535,5820,3285,56.4,43.6
3,1,2,2,1,1228,3953,2725,68.9,31.1
3,1,2,2,2,574,2597,2023,77.9,22.1
3,1,2,2,3,263,1650,1387,84.1,15.9
3,1,2,2,4,83,1044,961,92,8
3,1,2,2,5,50,597,547,91.6,8.39999999999999
3,1,2,2,6,10,356,346,97.2,2.8
3,1,2,2,7,7,177,170,96,4
3,1,2,2,8,1,86,85,98.8,1.2
3,1,2,2,9,1,40,39,97.5,2.5
3,1,2,2,10,0,16,16,100,0
3,1,2,2,11,0,18,18,100,0
3,1,2,2,12,0,5,5,100,0
3,1,2,2,13,0,6,6,100,0
3,1,2,2,14,0,1,1,100,0
3,1,2,2,15,0,1,1,100,0
3,1,2,12,-13,2,2,0,0,100
3,1,2,12,-12,3,3,0,0,100
3,1,2,12,-11,3,3,0,0,100
3,1,2,12,-10,10,10,0,0,100
3,1,2,12,-9,13,13,0,0,100
3,1,2,12,-8,41,42,1,2.4,97.6
3,1,2,12,-7,79,82,3,3.7,96.3
3,1,2,12,-6,126,137,11,8,92
3,1,2,12,-5,239,269,30,11.2,88.8
3,1,2,12,-4,452,541,89,16.5,83.5
3,1,2,12,-3,677,879,202,23,77
3,1,2,12,-2,972,1446,474,32.8,67.2
3,1,2,12,-1,1233,2239,1006,44.9,55.1
3,1,2,12,0,1652,3838,2186,57,43
3,1,2,12,1,907,2984,2077,69.6,30.4
3,1,2,12,2,433,2103,1670,79.4,20.6
3,1,2,12,3,207,1420,1213,85.4,14.6
3,1,2,12,4,66,925,859,92.9,7.09999999999999
3,1,2,12,5,36,518,482,93.1,6.89999999999999
3,1,2,12,6,2,250,248,99.2,0.799999999999997
3,1,2,12,7,3,165,162,98.2,1.8
3,1,2,12,8,2,84,82,97.6,2.40000000000001
3,1,2,12,9,0,39,39,100,0
3,1,2,12,10,0,24,24,100,0
3,1,2,12,11,1,15,14,93.3,6.69999999999999
3,1,2,12,12,0,2,2,100,0
3,1,2,12,13,0,3,3,100,0
3,1,2,12,14,0,3,3,100,0
3,1,2,3,-10,4,4,0,0,100
3,1,2,3,-9,4,5,1,20,80
3,1,2,3,-8,24,24,0,0,100
3,1,2,3,-7,27,28,1,3.6,96.4
3,1,2,3,-6,63,66,3,4.5,95.5
3,1,2,3,-5,104,113,9,8,92
3,1,2,3,-4,204,237,33,13.9,86.1
3,1,2,3,-3,300,397,97,24.4,75.6
3,1,2,3,-2,468,698,230,33,67
3,1,2,3,-1,727,1293,566,43.8,56.2
3,1,2,3,0,956,2262,1306,57.7,42.3
3,1,2,3,1,578,1723,1145,66.5,33.5
3,1,2,3,2,254,1118,864,77.3,22.7
3,1,2,3,3,99,713,614,86.1,13.9
3,1,2,3,4,41,387,346,89.4,10.6
3,1,2,3,5,23,266,243,91.4,8.59999999999999
3,1,2,3,6,8,131,123,93.9,6.10000000000001
3,1,2,3,7,4,73,69,94.5,5.5
3,1,2,3,8,1,24,23,95.8,4.2
3,1,2,3,9,0,12,12,100,0
3,1,2,3,10,0,7,7,100,0
3,1,2,3,11,0,5,5,100,0
3,1,2,3,12,0,2,2,100,0
3,1,2,13,-12,1,1,0,0,100
3,1,2,13,-11,3,3,0,0,100
3,1,2,13,-10,2,2,0,0,100
3,1,2,13,-9,9,9,0,0,100
3,1,2,13,-8,22,22,0,0,100
3,1,2,13,-7,34,37,3,8.1,91.9
3,1,2,13,-6,70,74,4,5.4,94.6
3,1,2,13,-5,99,108,9,8.3,91.7
3,1,2,13,-4,176,211,35,16.6,83.4
3,1,2,13,-3,316,418,102,24.4,75.6
3,1,2,13,-2,464,688,224,32.6,67.4
3,1,2,13,-1,600,1099,499,45.4,54.6
3,1,2,13,0,777,1859,1082,58.2,41.8
3,1,2,13,1,490,1578,1088,68.9,31.1
3,1,2,13,2,232,1151,919,79.8,20.2
3,1,2,13,3,95,721,626,86.8,13.2
3,1,2,13,4,31,462,431,93.3,6.69999999999999
3,1,2,13,5,13,272,259,95.2,4.80000000000001
3,1,2,13,6,2,144,142,98.6,1.40000000000001
3,1,2,13,7,4,76,72,94.7,5.30000000000001
3,1,2,13,8,0,40,40,100,0
3,1,2,13,9,0,23,23,100,0
3,1,2,13,10,1,6,5,83.3,16.7
3,1,2,13,11,1,6,5,83.3,16.7
3,1,2,13,12,0,4,4,100,0
3,1,2,13,13,0,1,1,100,0
3,1,2,13,14,0,1,1,100,0
3,1,2,23,-13,1,1,0,0,100
3,1,2,23,-12,2,2,0,0,100
3,1,2,23,-11,1,1,0,0,100
3,1,2,23,-10,4,4,0,0,100
3,1,2,23,-9,5,5,0,0,100
3,1,2,23,-8,9,9,0,0,100
3,1,2,23,-7,20,21,1,4.8,95.2
3,1,2,23,-6,31,34,3,8.8,91.2
3,1,2,23,-5,49,62,13,21,79
3,1,2,23,-4,111,136,25,18.4,81.6
3,1,2,23,-3,181,236,55,23.3,76.7
3,1,2,23,-2,241,399,158,39.6,60.4
3,1,2,23,-1,339,630,291,46.2,53.8
3,1,2,23,0,414,1009,595,59,41
3,1,2,23,1,217,863,646,74.9,25.1
3,1,2,23,2,126,627,501,79.9,20.1
3,1,2,23,3,48,407,359,88.2,11.8
3,1,2,23,4,21,296,275,92.9,7.09999999999999
3,1,2,23,5,13,184,171,92.9,7.09999999999999
3,1,2,23,6,8,99,91,91.9,8.09999999999999
3,1,2,23,7,1,64,63,98.4,1.59999999999999
3,1,2,23,8,1,32,31,96.9,3.10000000000001
3,1,2,23,9,0,17,17,100,0
3,1,2,23,10,0,10,10,100,0
3,1,2,23,11,0,5,5,100,0
3,1,2,23,12,0,2,2,100,0
3,1,2,23,13,0,1,1,100,0
3,1,2,123,-12,2,2,0,0,100
3,1,2,123,-10,3,3,0,0,100
3,1,2,123,-9,5,5,0,0,100
3,1,2,123,-8,8,8,0,0,100
3,1,2,123,-7,23,24,1,4.2,95.8
3,1,2,123,-6,34,41,7,17.1,82.9
3,1,2,123,-5,48,59,11,18.6,81.4
3,1,2,123,-4,126,155,29,18.7,81.3
3,1,2,123,-3,206,287,81,28.2,71.8
3,1,2,123,-2,258,423,165,39,61
3,1,2,123,-1,367,714,347,48.6,51.4
3,1,2,123,0,480,1206,726,60.2,39.8
3,1,2,123,1,308,1060,752,70.9,29.1
3,1,2,123,2,140,800,660,82.5,17.5
3,1,2,123,3,69,546,477,87.4,12.6
3,1,2,123,4,24,358,334,93.3,6.69999999999999
3,1,2,123,5,11,227,216,95.2,4.80000000000001
3,1,2,123,6,5,118,113,95.8,4.2
3,1,2,123,7,1,75,74,98.7,1.3
3,1,2,123,8,1,38,37,97.4,2.60000000000001
3,1,2,123,9,0,26,26,100,0
3,1,2,123,10,0,14,14,100,0
3,1,2,123,11,0,5,5,100,0
3,1,2,123,12,0,4,4,100,0
3,1,2,123,13,0,3,3,100,0
4,0,0,0,-18,1,1,0,0,100
4,0,0,0,-16,1,1,0,0,100
4,0,0,0,-15,1,1,0,0,100
4,0,0,0,-14,2,2,0,0,100
4,0,0,0,-13,15,15,0,0,100
4,0,0,0,-12,21,22,1,4.5,95.5
4,0,0,0,-11,43,44,1,2.3,97.7
4,0,0,0,-10,99,99,0,0,100
4,0,0,0,-9,165,168,3,1.8,98.2
4,0,0,0,-8,317,321,4,1.2,98.8
4,0,0,0,-7,617,635,18,2.8,97.2
4,0,0,0,-6,1221,1285,64,5,95
4,0,0,0,-5,2101,2305,204,8.9,91.1
4,0,0,0,-4,3800,4300,500,11.6,88.4
4,0,0,0,-3,6051,7493,1442,19.2,80.8
4,0,0,0,-2,8998,12338,3340,27.1,72.9
4,0,0,0,-1,12057,19590,7533,38.5,61.5
4,0,0,0,0,15855,32770,16915,51.6,48.4
4,0,0,0,1,7269,20560,13291,64.6,35.4
4,0,0,0,2,3186,13274,10088,76,24
4,0,0,0,3,1402,8509,7107,83.5,16.5
4,0,0,0,4,502,5241,4739,90.4,9.59999999999999
4,0,0,0,5,219,3051,2832,92.8,7.19999999999999
4,0,0,0,6,67,1628,1561,95.9,4.10000000000001
4,0,0,0,7,23,853,830,97.3,2.7
4,0,0,0,8,7,424,417,98.3,1.7
4,0,0,0,9,2,216,214,99.1,0.900000000000006
4,0,0,0,10,0,94,94,100,0
4,0,0,0,11,2,69,67,97.1,2.90000000000001
4,0,0,0,12,0,28,28,100,0
4,0,0,0,13,0,20,20,100,0
4,0,0,0,14,0,7,7,100,0
4,0,0,0,15,0,3,3,100,0
4,0,0,0,16,0,1,1,100,0
4,0,0,0,17,0,1,1,100,0
4,0,0,0,18,0,1,1,100,0
4,0,0,1,-14,1,1,0,0,100
4,0,0,1,-13,4,4,0,0,100
4,0,0,1,-12,4,4,0,0,100
4,0,0,1,-11,10,10,0,0,100
4,0,0,1,-10,28,28,0,0,100
4,0,0,1,-9,52,53,1,1.9,98.1
4,0,0,1,-8,117,119,2,1.7,98.3
4,0,0,1,-7,167,171,4,2.3,97.7
4,0,0,1,-6,325,344,19,5.5,94.5
4,0,0,1,-5,545,600,55,9.2,90.8
4,0,0,1,-4,1030,1129,99,8.8,91.2
4,0,0,1,-3,1610,1949,339,17.4,82.6
4,0,0,1,-2,2433,3238,805,24.9,75.1
4,0,0,1,-1,3299,5034,1735,34.5,65.5
4,0,0,1,0,4463,8464,4001,47.3,52.7
4,0,0,1,1,2137,5337,3200,60,40
4,0,0,1,2,945,3373,2428,72,28
4,0,0,1,3,429,2135,1706,79.9,20.1
4,0,0,1,4,162,1353,1191,88,12
4,0,0,1,5,71,792,721,91,9
4,0,0,1,6,32,410,378,92.2,7.8
4,0,0,1,7,4,210,206,98.1,1.90000000000001
4,0,0,1,8,2,108,106,98.1,1.90000000000001
4,0,0,1,9,0,44,44,100,0
4,0,0,1,10,0,17,17,100,0
4,0,0,1,11,2,15,13,86.7,13.3
4,0,0,1,12,0,11,11,100,0
4,0,0,1,13,0,4,4,100,0
4,0,0,1,14,0,2,2,100,0
4,0,0,1,18,0,1,1,100,0
4,0,0,2,-16,1,1,0,0,100
4,0,0,2,-12,1,1,0,0,100
4,0,0,2,-11,6,7,1,14.3,85.7
4,0,0,2,-10,10,10,0,0,100
4,0,0,2,-9,18,19,1,5.3,94.7
4,0,0,2,-8,36,36,0,0,100
4,0,0,2,-7,53,55,2,3.6,96.4
4,0,0,2,-6,113,117,4,3.4,96.6
4,0,0,2,-5,180,190,10,5.3,94.7
4,0,0,2,-4,341,384,43,11.2,88.8
4,0,0,2,-3,528,638,110,17.2,82.8
4,0,0,2,-2,779,1027,248,24.1,75.9
4,0,0,2,-1,1121,1619,498,30.8,69.2
4,0,0,2,0,1362,2341,979,41.8,58.2
4,0,0,2,1,633,1450,817,56.3,43.7
4,0,0,2,2,283,888,605,68.1,31.9
4,0,0,2,3,135,552,417,75.5,24.5
4,0,0,2,4,46,341,295,86.5,13.5
4,0,0,2,5,21,213,192,90.1,9.89999999999999
4,0,0,2,6,5,107,102,95.3,4.7
4,0,0,2,7,1,49,48,98,2
4,0,0,2,8,0,23,23,100,0
4,0,0,2,9,0,16,16,100,0
4,0,0,2,10,0,4,4,100,0
4,0,0,2,11,0,4,4,100,0
4,0,0,2,12,0,1,1,100,0
4,0,0,2,13,0,3,3,100,0
4,0,0,12,-12,1,1,0,0,100
4,0,0,12,-11,6,6,0,0,100
4,0,0,12,-10,7,7,0,0,100
4,0,0,12,-9,16,16,0,0,100
4,0,0,12,-8,34,34,0,0,100
4,0,0,12,-7,41,44,3,6.8,93.2
4,0,0,12,-6,92,92,0,0,100
4,0,0,12,-5,162,170,8,4.7,95.3
4,0,0,12,-4,263,284,21,7.4,92.6
4,0,0,12,-3,384,450,66,14.7,85.3
4,0,0,12,-2,605,760,155,20.4,79.6
4,0,0,12,-1,887,1243,356,28.6,71.4
4,0,0,12,0,1066,1782,716,40.2,59.8
4,0,0,12,1,548,1158,610,52.7,47.3
4,0,0,12,2,277,756,479,63.4,36.6
4,0,0,12,3,132,511,379,74.2,25.8
4,0,0,12,4,48,347,299,86.2,13.8
4,0,0,12,5,22,179,157,87.7,12.3
4,0,0,12,6,8,96,88,91.7,8.3
4,0,0,12,7,0,51,51,100,0
4,0,0,12,8,0,24,24,100,0
4,0,0,12,9,0,13,13,100,0
4,0,0,12,10,0,12,12,100,0
4,0,0,12,11,0,4,4,100,0
4,0,0,12,12,0,1,1,100,0
4,0,0,12,13,0,2,2,100,0
4,0,0,12,18,0,1,1,100,0
4,0,0,3,-12,1,1,0,0,100
4,0,0,3,-11,1,1,0,0,100
4,0,0,3,-10,3,3,0,0,100
4,0,0,3,-9,5,5,0,0,100
4,0,0,3,-8,6,6,0,0,100
4,0,0,3,-7,18,19,1,5.3,94.7
4,0,0,3,-6,22,23,1,4.3,95.7
4,0,0,3,-5,30,32,2,6.2,93.8
4,0,0,3,-4,71,79,8,10.1,89.9
4,0,0,3,-3,108,124,16,12.9,87.1
4,0,0,3,-2,145,183,38,20.8,79.2
4,0,0,3,-1,205,289,84,29.1,70.9
4,0,0,3,0,223,406,183,45.1,54.9
4,0,0,3,1,110,248,138,55.6,44.4
4,0,0,3,2,56,139,83,59.7,40.3
4,0,0,3,3,16,80,64,80,20
4,0,0,3,4,4,54,50,92.6,7.39999999999999
4,0,0,3,5,5,27,22,81.5,18.5
4,0,0,3,6,0,28,28,100,0
4,0,0,3,7,0,8,8,100,0
4,0,0,3,8,0,3,3,100,0
4,0,0,3,9,0,2,2,100,0
4,0,0,3,10,0,1,1,100,0
4,0,0,13,-16,1,1,0,0,100
4,0,0,13,-14,1,1,0,0,100
4,0,0,13,-11,3,3,0,0,100
4,0,0,13,-10,3,3,0,0,100
4,0,0,13,-9,8,8,0,0,100
4,0,0,13,-8,13,14,1,7.1,92.9
4,0,0,13,-7,27,27,0,0,100
4,0,0,13,-6,38,38,0,0,100
4,0,0,13,-5,67,71,4,5.6,94.4
4,0,0,13,-4,109,116,7,6,94
4,0,0,13,-3,202,232,30,12.9,87.1
4,0,0,13,-2,251,322,71,22,78
4,0,0,13,-1,422,575,153,26.6,73.4
4,0,0,13,0,473,748,275,36.8,63.2
4,0,0,13,1,235,476,241,50.6,49.4
4,0,0,13,2,113,285,172,60.4,39.6
4,0,0,13,3,56,168,112,66.7,33.3
4,0,0,13,4,18,113,95,84.1,15.9
4,0,0,13,5,11,61,50,82,18
4,0,0,13,6,2,34,32,94.1,5.90000000000001
4,0,0,13,7,1,16,15,93.8,6.2
4,0,0,13,8,1,10,9,90,10
4,0,0,13,9,0,3,3,100,0
4,0,0,13,11,0,5,5,100,0
4,0,0,23,-13,1,1,0,0,100
4,0,0,23,-12,2,2,0,0,100
4,0,0,23,-10,3,3,0,0,100
4,0,0,23,-9,4,4,0,0,100
4,0,0,23,-8,8,8,0,0,100
4,0,0,23,-7,23,23,0,0,100
4,0,0,23,-6,34,36,2,5.6,94.4
4,0,0,23,-5,42,45,3,6.7,93.3
4,0,0,23,-4,88,92,4,4.3,95.7
4,0,0,23,-3,126,139,13,9.4,90.6
4,0,0,23,-2,184,216,32,14.8,85.2
4,0,0,23,-1,269,353,84,23.8,76.2
4,0,0,23,0,281,420,139,33.1,66.9
4,0,0,23,1,144,294,150,51,49
4,0,0,23,2,62,180,118,65.6,34.4
4,0,0,23,3,34,114,80,70.2,29.8
4,0,0,23,4,15,79,64,81,19
4,0,0,23,5,4,39,35,89.7,10.3
4,0,0,23,6,2,20,18,90,10
4,0,0,23,7,0,8,8,100,0
4,0,0,23,8,0,5,5,100,0
4,0,0,23,9,0,2,2,100,0
4,0,0,23,10,0,2,2,100,0
4,0,0,123,-14,1,1,0,0,100
4,0,0,123,-11,1,1,0,0,100
4,0,0,123,-10,3,3,0,0,100
4,0,0,123,-9,2,2,0,0,100
4,0,0,123,-8,11,11,0,0,100
4,0,0,123,-7,20,20,0,0,100
4,0,0,123,-6,26,26,0,0,100
4,0,0,123,-5,59,59,0,0,100
4,0,0,123,-4,90,94,4,4.3,95.7
4,0,0,123,-3,131,138,7,5.1,94.9
4,0,0,123,-2,182,206,24,11.7,88.3
4,0,0,123,-1,265,322,57,17.7,82.3
4,0,0,123,0,265,377,112,29.7,70.3
4,0,0,123,1,139,247,108,43.7,56.3
4,0,0,123,2,69,161,92,57.1,42.9
4,0,0,123,3,43,116,73,62.9,37.1
4,0,0,123,4,17,73,56,76.7,23.3
4,0,0,123,5,7,28,21,75,25
4,0,0,123,6,2,21,19,90.5,9.5
4,0,0,123,7,0,11,11,100,0
4,0,0,123,8,0,3,3,100,0
4,0,0,123,9,0,3,3,100,0
4,0,0,123,10,0,2,2,100,0
4,0,0,123,11,0,2,2,100,0
4,0,0,123,12,0,1,1,100,0
4,0,1,0,-19,1,1,0,0,100
4,0,1,0,-18,1,1,0,0,100
4,0,1,0,-15,2,2,0,0,100
4,0,1,0,-14,1,1,0,0,100
4,0,1,0,-13,13,13,0,0,100
4,0,1,0,-12,21,22,1,4.5,95.5
4,0,1,0,-11,40,40,0,0,100
4,0,1,0,-10,84,84,0,0,100
4,0,1,0,-9,134,135,1,0.7,99.3
4,0,1,0,-8,258,261,3,1.1,98.9
4,0,1,0,-7,530,545,15,2.8,97.2
4,0,1,0,-6,949,1005,56,5.6,94.4
4,0,1,0,-5,1636,1802,166,9.2,90.8
4,0,1,0,-4,2902,3329,427,12.8,87.2
4,0,1,0,-3,4512,5690,1178,20.7,79.3
4,0,1,0,-2,6624,9282,2658,28.6,71.4
4,0,1,0,-1,8413,14263,5850,41,59
4,0,1,0,0,10297,22719,12422,54.7,45.3
4,0,1,0,1,4539,14161,9622,67.9,32.1
4,0,1,0,2,1927,9152,7225,78.9,21.1
4,0,1,0,3,843,5907,5064,85.7,14.3
4,0,1,0,4,294,3540,3246,91.7,8.3
4,0,1,0,5,117,2037,1920,94.3,5.7
4,0,1,0,6,29,1088,1059,97.3,2.7
4,0,1,0,7,18,591,573,97,3
4,0,1,0,8,4,292,288,98.6,1.40000000000001
4,0,1,0,9,2,155,153,98.7,1.3
4,0,1,0,10,0,70,70,100,0
4,0,1,0,11,0,52,52,100,0
4,0,1,0,12,0,17,17,100,0
4,0,1,0,13,0,14,14,100,0
4,0,1,0,14,0,3,3,100,0
4,0,1,0,15,0,3,3,100,0
4,0,1,0,16,0,1,1,100,0
4,0,1,0,17,0,1,1,100,0
4,0,1,1,-15,2,2,0,0,100
4,0,1,1,-13,4,4,0,0,100
4,0,1,1,-12,7,7,0,0,100
4,0,1,1,-11,15,15,0,0,100
4,0,1,1,-10,41,41,0,0,100
4,0,1,1,-9,73,74,1,1.4,98.6
4,0,1,1,-8,137,141,4,2.8,97.2
4,0,1,1,-7,241,245,4,1.6,98.4
4,0,1,1,-6,453,475,22,4.6,95.4
4,0,1,1,-5,733,808,75,9.3,90.7
4,0,1,1,-4,1284,1462,178,12.2,87.8
4,0,1,1,-3,1950,2402,452,18.8,81.2
4,0,1,1,-2,2832,3851,1019,26.5,73.5
4,0,1,1,-1,3663,5984,2321,38.8,61.2
4,0,1,1,0,4502,9211,4709,51.1,48.9
4,0,1,1,1,2119,5913,3794,64.2,35.8
4,0,1,1,2,935,3854,2919,75.7,24.3
4,0,1,1,3,425,2460,2035,82.7,17.3
4,0,1,1,4,142,1480,1338,90.4,9.59999999999999
4,0,1,1,5,59,900,841,93.4,6.59999999999999
4,0,1,1,6,20,476,456,95.8,4.2
4,0,1,1,7,8,260,252,96.9,3.10000000000001
4,0,1,1,8,1,115,114,99.1,0.900000000000006
4,0,1,1,9,0,56,56,100,0
4,0,1,1,10,0,19,19,100,0
4,0,1,1,11,2,21,19,90.5,9.5
4,0,1,1,12,0,14,14,100,0
4,0,1,1,13,0,8,8,100,0
4,0,1,1,14,0,1,1,100,0
4,0,1,2,-14,1,1,0,0,100
4,0,1,2,-13,2,2,0,0,100
4,0,1,2,-12,4,4,0,0,100
4,0,1,2,-11,10,12,2,16.7,83.3
4,0,1,2,-10,24,24,0,0,100
4,0,1,2,-9,39,42,3,7.1,92.9
4,0,1,2,-8,71,72,1,1.4,98.6
4,0,1,2,-7,112,117,5,4.3,95.7
4,0,1,2,-6,202,220,18,8.2,91.8
4,0,1,2,-5,421,460,39,8.5,91.5
4,0,1,2,-4,688,786,98,12.5,87.5
4,0,1,2,-3,1051,1289,238,18.5,81.5
4,0,1,2,-2,1474,1985,511,25.7,74.3
4,0,1,2,-1,1680,2646,966,36.5,63.5
4,0,1,2,0,1897,3730,1833,49.1,50.9
4,0,1,2,1,845,2178,1333,61.2,38.8
4,0,1,2,2,335,1333,998,74.9,25.1
4,0,1,2,3,132,809,677,83.7,16.3
4,0,1,2,4,47,430,383,89.1,10.9
4,0,1,2,5,24,282,258,91.5,8.5
4,0,1,2,6,4,168,164,97.6,2.40000000000001
4,0,1,2,7,3,77,74,96.1,3.90000000000001
4,0,1,2,8,0,35,35,100,0
4,0,1,2,9,0,17,17,100,0
4,0,1,2,10,0,10,10,100,0
4,0,1,2,11,0,10,10,100,0
4,0,1,2,12,0,3,3,100,0
4,0,1,2,13,0,2,2,100,0
4,0,1,2,14,0,1,1,100,0
4,0,1,12,-16,1,1,0,0,100
4,0,1,12,-15,1,1,0,0,100
4,0,1,12,-13,2,2,0,0,100
4,0,1,12,-12,6,6,0,0,100
4,0,1,12,-11,8,8,0,0,100
4,0,1,12,-10,14,14,0,0,100
4,0,1,12,-9,35,35,0,0,100
4,0,1,12,-8,84,85,1,1.2,98.8
4,0,1,12,-7,104,108,4,3.7,96.3
4,0,1,12,-6,210,215,5,2.3,97.7
4,0,1,12,-5,334,364,30,8.2,91.8
4,0,1,12,-4,468,522,54,10.3,89.7
4,0,1,12,-3,730,872,142,16.3,83.7
4,0,1,12,-2,1098,1431,333,23.3,76.7
4,0,1,12,-1,1369,2106,737,35,65
4,0,1,12,0,1494,2862,1368,47.8,52.2
4,0,1,12,1,748,1854,1106,59.7,40.3
4,0,1,12,2,359,1208,849,70.3,29.7
4,0,1,12,3,181,826,645,78.1,21.9
4,0,1,12,4,48,508,460,90.6,9.39999999999999
4,0,1,12,5,27,295,268,90.8,9.2
4,0,1,12,6,15,173,158,91.3,8.7
4,0,1,12,7,0,77,77,100,0
4,0,1,12,8,1,41,40,97.6,2.40000000000001
4,0,1,12,9,0,15,15,100,0
4,0,1,12,10,0,13,13,100,0
4,0,1,12,11,0,8,8,100,0
4,0,1,12,12,0,6,6,100,0
4,0,1,12,13,0,3,3,100,0
4,0,1,12,14,0,1,1,100,0
4,0,1,3,-14,1,1,0,0,100
4,0,1,3,-12,1,1,0,0,100
4,0,1,3,-11,7,7,0,0,100
4,0,1,3,-10,6,6,0,0,100
4,0,1,3,-9,10,10,0,0,100
4,0,1,3,-8,30,30,0,0,100
4,0,1,3,-7,45,46,1,2.2,97.8
4,0,1,3,-6,83,86,3,3.5,96.5
4,0,1,3,-5,135,143,8,5.6,94.4
4,0,1,3,-4,265,299,34,11.4,88.6
4,0,1,3,-3,406,490,84,17.1,82.9
4,0,1,3,-2,571,731,160,21.9,78.1
4,0,1,3,-1,652,970,318,32.8,67.2
4,0,1,3,0,682,1248,566,45.4,54.6
4,0,1,3,1,320,748,428,57.2,42.8
4,0,1,3,2,107,439,332,75.6,24.4
4,0,1,3,3,57,265,208,78.5,21.5
4,0,1,3,4,11,148,137,92.6,7.39999999999999
4,0,1,3,5,6,76,70,92.1,7.89999999999999
4,0,1,3,6,3,44,41,93.2,6.8
4,0,1,3,7,0,23,23,100,0
4,0,1,3,8,0,6,6,100,0
4,0,1,3,9,0,5,5,100,0
4,0,1,3,10,0,3,3,100,0
4,0,1,3,11,0,2,2,100,0
4,0,1,3,12,0,1,1,100,0
4,0,1,3,13,0,2,2,100,0
4,0,1,13,-16,1,1,0,0,100
4,0,1,13,-13,1,1,0,0,100
4,0,1,13,-12,2,2,0,0,100
4,0,1,13,-11,6,6,0,0,100
4,0,1,13,-10,9,9,0,0,100
4,0,1,13,-9,20,20,0,0,100
4,0,1,13,-8,32,35,3,8.6,91.4
4,0,1,13,-7,69,69,0,0,100
4,0,1,13,-6,116,118,2,1.7,98.3
4,0,1,13,-5,174,186,12,6.5,93.5
4,0,1,13,-4,300,329,29,8.8,91.2
4,0,1,13,-3,383,458,75,16.4,83.6
4,0,1,13,-2,588,762,174,22.8,77.2
4,0,1,13,-1,731,1059,328,31,69
4,0,1,13,0,800,1384,584,42.2,57.8
4,0,1,13,1,395,862,467,54.2,45.8
4,0,1,13,2,166,529,363,68.6,31.4
4,0,1,13,3,68,312,244,78.2,21.8
4,0,1,13,4,25,195,170,87.2,12.8
4,0,1,13,5,11,101,90,89.1,10.9
4,0,1,13,6,1,53,52,98.1,1.90000000000001
4,0,1,13,7,2,36,34,94.4,5.60000000000001
4,0,1,13,8,0,13,13,100,0
4,0,1,13,9,0,5,5,100,0
4,0,1,13,11,0,2,2,100,0
4,0,1,13,12,0,1,1,100,0
4,0,1,13,18,0,1,1,100,0
4,0,1,23,-14,1,1,0,0,100
4,0,1,23,-12,2,2,0,0,100
4,0,1,23,-11,3,3,0,0,100
4,0,1,23,-10,7,7,0,0,100
4,0,1,23,-9,14,16,2,12.5,87.5
4,0,1,23,-8,33,33,0,0,100
4,0,1,23,-7,39,40,1,2.5,97.5
4,0,1,23,-6,72,77,5,6.5,93.5
4,0,1,23,-5,140,148,8,5.4,94.6
4,0,1,23,-4,251,268,17,6.3,93.7
4,0,1,23,-3,337,402,65,16.2,83.8
4,0,1,23,-2,471,589,118,20,80
4,0,1,23,-1,594,833,239,28.7,71.3
4,0,1,23,0,517,925,408,44.1,55.9
4,0,1,23,1,274,571,297,52,48
4,0,1,23,2,115,368,253,68.8,31.2
4,0,1,23,3,47,211,164,77.7,22.3
4,0,1,23,4,17,142,125,88,12
4,0,1,23,5,7,63,56,88.9,11.1
4,0,1,23,6,1,28,27,96.4,3.60000000000001
4,0,1,23,7,1,22,21,95.5,4.5
4,0,1,23,8,0,9,9,100,0
4,0,1,23,9,0,1,1,100,0
4,0,1,23,10,0,6,6,100,0
4,0,1,23,11,0,3,3,100,0
4,0,1,23,12,0,1,1,100,0
4,0,1,123,-14,1,1,0,0,100
4,0,1,123,-10,5,6,1,16.7,83.3
4,0,1,123,-9,17,18,1,5.6,94.4
4,0,1,123,-8,29,29,0,0,100
4,0,1,123,-7,49,50,1,2,98
4,0,1,123,-6,86,89,3,3.4,96.6
4,0,1,123,-5,172,178,6,3.4,96.6
4,0,1,123,-4,212,230,18,7.8,92.2
4,0,1,123,-3,370,429,59,13.8,86.2
4,0,1,123,-2,492,591,99,16.8,83.2
4,0,1,123,-1,583,802,219,27.3,72.7
4,0,1,123,0,500,856,356,41.6,58.4
4,0,1,123,1,267,546,279,51.1,48.9
4,0,1,123,2,110,305,195,63.9,36.1
4,0,1,123,3,53,217,164,75.6,24.4
4,0,1,123,4,20,129,109,84.5,15.5
4,0,1,123,5,15,66,51,77.3,22.7
4,0,1,123,6,9,54,45,83.3,16.7
4,0,1,123,7,1,19,18,94.7,5.30000000000001
4,0,1,123,8,0,7,7,100,0
4,0,1,123,9,0,2,2,100,0
4,0,1,123,10,0,7,7,100,0
4,0,1,123,11,0,2,2,100,0
4,0,2,0,-19,1,1,0,0,100
4,0,2,0,-15,1,1,0,0,100
4,0,2,0,-14,4,4,0,0,100
4,0,2,0,-13,21,21,0,0,100
4,0,2,0,-12,26,27,1,3.7,96.3
4,0,2,0,-11,41,42,1,2.4,97.6
4,0,2,0,-10,95,95,0,0,100
4,0,2,0,-9,163,164,1,0.6,99.4
4,0,2,0,-8,292,297,5,1.7,98.3
4,0,2,0,-7,528,546,18,3.3,96.7
4,0,2,0,-6,860,917,57,6.2,93.8
4,0,2,0,-5,1457,1602,145,9.1,90.9
4,0,2,0,-4,2546,2939,393,13.4,86.6
4,0,2,0,-3,3862,4919,1057,21.5,78.5
4,0,2,0,-2,5539,7947,2408,30.3,69.7
4,0,2,0,-1,6687,11634,4947,42.5,57.5
4,0,2,0,0,7332,17259,9927,57.5,42.5
4,0,2,0,1,3150,10749,7599,70.7,29.3
4,0,2,0,2,1339,6900,5561,80.6,19.4
4,0,2,0,3,567,4455,3888,87.3,12.7
4,0,2,0,4,197,2697,2500,92.7,7.3
4,0,2,0,5,71,1528,1457,95.4,4.60000000000001
4,0,2,0,6,21,791,770,97.3,2.7
4,0,2,0,7,11,417,406,97.4,2.60000000000001
4,0,2,0,8,4,221,217,98.2,1.8
4,0,2,0,9,2,115,113,98.3,1.7
4,0,2,0,10,0,51,51,100,0
4,0,2,0,11,0,34,34,100,0
4,0,2,0,12,0,10,10,100,0
4,0,2,0,13,0,7,7,100,0
4,0,2,0,14,0,2,2,100,0
4,0,2,0,15,0,3,3,100,0
4,0,2,0,16,0,1,1,100,0
4,0,2,0,17,0,1,1,100,0
4,0,2,1,-17,1,1,0,0,100
4,0,2,1,-15,3,3,0,0,100
4,0,2,1,-14,2,2,0,0,100
4,0,2,1,-13,4,4,0,0,100
4,0,2,1,-12,20,20,0,0,100
4,0,2,1,-11,32,32,0,0,100
4,0,2,1,-10,57,57,0,0,100
4,0,2,1,-9,102,105,3,2.9,97.1
4,0,2,1,-8,194,199,5,2.5,97.5
4,0,2,1,-7,330,341,11,3.2,96.8
4,0,2,1,-6,615,660,45,6.8,93.2
4,0,2,1,-5,917,1003,86,8.6,91.4
4,0,2,1,-4,1516,1718,202,11.8,88.2
4,0,2,1,-3,2195,2743,548,20,80
4,0,2,1,-2,2952,4162,1210,29.1,70.9
4,0,2,1,-1,3561,6054,2493,41.2,58.8
4,0,2,1,0,3860,8467,4607,54.4,45.6
4,0,2,1,1,1747,5473,3726,68.1,31.9
4,0,2,1,2,732,3503,2771,79.1,20.9
4,0,2,1,3,311,2286,1975,86.4,13.6
4,0,2,1,4,103,1379,1276,92.5,7.5
4,0,2,1,5,42,804,762,94.8,5.2
4,0,2,1,6,16,435,419,96.3,3.7
4,0,2,1,7,7,221,214,96.8,3.2
4,0,2,1,8,2,117,115,98.3,1.7
4,0,2,1,9,1,56,55,98.2,1.8
4,0,2,1,10,0,23,23,100,0
4,0,2,1,11,2,15,13,86.7,13.3
4,0,2,1,12,0,7,7,100,0
4,0,2,1,13,0,7,7,100,0
4,0,2,2,-14,3,3,0,0,100
4,0,2,2,-13,3,3,0,0,100
4,0,2,2,-12,11,11,0,0,100
4,0,2,2,-11,15,16,1,6.2,93.8
4,0,2,2,-10,32,32,0,0,100
4,0,2,2,-9,71,73,2,2.7,97.3
4,0,2,2,-8,108,112,4,3.6,96.4
4,0,2,2,-7,167,173,6,3.5,96.5
4,0,2,2,-6,363,394,31,7.9,92.1
4,0,2,2,-5,700,755,55,7.3,92.7
4,0,2,2,-4,1079,1235,156,12.6,87.4
4,0,2,2,-3,1525,1878,353,18.8,81.2
4,0,2,2,-2,1963,2687,724,26.9,73.1
4,0,2,2,-1,2058,3485,1427,40.9,59.1
4,0,2,2,0,2044,4287,2243,52.3,47.7
4,0,2,2,1,835,2549,1714,67.2,32.8
4,0,2,2,2,331,1520,1189,78.2,21.8
4,0,2,2,3,128,964,836,86.7,13.3
4,0,2,2,4,46,535,489,91.4,8.59999999999999
4,0,2,2,5,25,334,309,92.5,7.5
4,0,2,2,6,4,176,172,97.7,2.3
4,0,2,2,7,1,81,80,98.8,1.2
4,0,2,2,8,0,39,39,100,0
4,0,2,2,9,0,23,23,100,0
4,0,2,2,10,0,12,12,100,0
4,0,2,2,11,0,8,8,100,0
4,0,2,2,12,0,4,4,100,0
4,0,2,2,13,0,3,3,100,0
4,0,2,2,14,0,1,1,100,0
4,0,2,12,-16,2,2,0,0,100
4,0,2,12,-15,1,1,0,0,100
4,0,2,12,-13,2,2,0,0,100
4,0,2,12,-12,14,14,0,0,100
4,0,2,12,-11,17,17,0,0,100
4,0,2,12,-10,26,26,0,0,100
4,0,2,12,-9,55,55,0,0,100
4,0,2,12,-8,112,115,3,2.6,97.4
4,0,2,12,-7,199,202,3,1.5,98.5
4,0,2,12,-6,320,343,23,6.7,93.3
4,0,2,12,-5,520,561,41,7.3,92.7
4,0,2,12,-4,797,893,96,10.8,89.2
4,0,2,12,-3,1090,1326,236,17.8,82.2
4,0,2,12,-2,1532,2101,569,27.1,72.9
4,0,2,12,-1,1694,2745,1051,38.3,61.7
4,0,2,12,0,1594,3382,1788,52.9,47.1
4,0,2,12,1,737,2105,1368,65,35
4,0,2,12,2,320,1399,1079,77.1,22.9
4,0,2,12,3,141,922,781,84.7,15.3
4,0,2,12,4,47,570,523,91.8,8.2
4,0,2,12,5,21,318,297,93.4,6.59999999999999
4,0,2,12,6,8,155,147,94.8,5.2
4,0,2,12,7,2,89,87,97.8,2.2
4,0,2,12,8,1,38,37,97.4,2.60000000000001
4,0,2,12,9,1,26,25,96.2,3.8
4,0,2,12,10,1,6,5,83.3,16.7
4,0,2,12,11,1,7,6,85.7,14.3
4,0,2,12,12,0,6,6,100,0
4,0,2,12,13,0,5,5,100,0
4,0,2,12,17,0,1,1,100,0
4,0,2,3,-15,1,1,0,0,100
4,0,2,3,-14,1,1,0,0,100
4,0,2,3,-13,1,1,0,0,100
4,0,2,3,-12,2,2,0,0,100
4,0,2,3,-11,11,11,0,0,100
4,0,2,3,-10,11,11,0,0,100
4,0,2,3,-9,32,33,1,3,97
4,0,2,3,-8,56,56,0,0,100
4,0,2,3,-7,84,89,5,5.6,94.4
4,0,2,3,-6,156,167,11,6.6,93.4
4,0,2,3,-5,235,258,23,8.9,91.1
4,0,2,3,-4,433,497,64,12.9,87.1
4,0,2,3,-3,601,746,145,19.4,80.6
4,0,2,3,-2,743,1055,312,29.6,70.4
4,0,2,3,-1,883,1451,568,39.1,60.9
4,0,2,3,0,836,1755,919,52.4,47.6
4,0,2,3,1,333,1013,680,67.1,32.9
4,0,2,3,2,129,610,481,78.9,21.1
4,0,2,3,3,53,369,316,85.6,14.4
4,0,2,3,4,17,210,193,91.9,8.09999999999999
4,0,2,3,5,8,123,115,93.5,6.5
4,0,2,3,6,2,75,73,97.3,2.7
4,0,2,3,7,1,26,25,96.2,3.8
4,0,2,3,8,0,16,16,100,0
4,0,2,3,9,0,11,11,100,0
4,0,2,3,10,0,6,6,100,0
4,0,2,3,11,0,4,4,100,0
4,0,2,3,12,0,1,1,100,0
4,0,2,13,-15,2,2,0,0,100
4,0,2,13,-13,2,2,0,0,100
4,0,2,13,-12,2,2,0,0,100
4,0,2,13,-11,6,6,0,0,100
4,0,2,13,-10,17,17,0,0,100
4,0,2,13,-9,23,25,2,8,92
4,0,2,13,-8,55,58,3,5.2,94.8
4,0,2,13,-7,91,92,1,1.1,98.9
4,0,2,13,-6,182,192,10,5.2,94.8
4,0,2,13,-5,276,301,25,8.3,91.7
4,0,2,13,-4,429,489,60,12.3,87.7
4,0,2,13,-3,595,725,130,17.9,82.1
4,0,2,13,-2,757,1021,264,25.9,74.1
4,0,2,13,-1,794,1310,516,39.4,60.6
4,0,2,13,0,759,1547,788,50.9,49.1
4,0,2,13,1,344,946,602,63.6,36.4
4,0,2,13,2,176,658,482,73.3,26.7
4,0,2,13,3,58,365,307,84.1,15.9
4,0,2,13,4,25,221,196,88.7,11.3
4,0,2,13,5,11,122,111,91,9
4,0,2,13,6,2,68,66,97.1,2.90000000000001
4,0,2,13,7,0,40,40,100,0
4,0,2,13,8,0,12,12,100,0
4,0,2,13,9,0,10,10,100,0
4,0,2,13,10,0,1,1,100,0
4,0,2,13,11,0,5,5,100,0
4,0,2,13,12,0,2,2,100,0
4,0,2,13,18,0,1,1,100,0
4,0,2,23,-13,2,2,0,0,100
4,0,2,23,-12,4,4,0,0,100
4,0,2,23,-11,5,5,0,0,100
4,0,2,23,-10,14,14,0,0,100
4,0,2,23,-9,22,22,0,0,100
4,0,2,23,-8,33,34,1,2.9,97.1
4,0,2,23,-7,57,59,2,3.4,96.6
4,0,2,23,-6,101,111,10,9,91
4,0,2,23,-5,173,187,14,7.5,92.5
4,0,2,23,-4,270,315,45,14.3,85.7
4,0,2,23,-3,430,529,99,18.7,81.3
4,0,2,23,-2,508,675,167,24.7,75.3
4,0,2,23,-1,539,850,311,36.6,63.4
4,0,2,23,0,487,952,465,48.8,51.2
4,0,2,23,1,228,590,362,61.4,38.6
4,0,2,23,2,100,368,268,72.8,27.2
4,0,2,23,3,35,234,199,85,15
4,0,2,23,4,17,159,142,89.3,10.7
4,0,2,23,5,9,64,55,85.9,14.1
4,0,2,23,6,2,51,49,96.1,3.90000000000001
4,0,2,23,7,0,19,19,100,0
4,0,2,23,8,1,18,17,94.4,5.60000000000001
4,0,2,23,9,0,5,5,100,0
4,0,2,23,10,0,7,7,100,0
4,0,2,23,11,1,4,3,75,25
4,0,2,23,12,0,1,1,100,0
4,0,2,23,13,0,1,1,100,0
4,0,2,123,-17,1,1,0,0,100
4,0,2,123,-16,1,1,0,0,100
4,0,2,123,-14,1,1,0,0,100
4,0,2,123,-13,2,2,0,0,100
4,0,2,123,-12,5,5,0,0,100
4,0,2,123,-11,6,6,0,0,100
4,0,2,123,-10,14,15,1,6.7,93.3
4,0,2,123,-9,30,31,1,3.2,96.8
4,0,2,123,-8,38,39,1,2.6,97.4
4,0,2,123,-7,71,73,2,2.7,97.3
4,0,2,123,-6,121,126,5,4,96
4,0,2,123,-5,188,203,15,7.4,92.6
4,0,2,123,-4,303,353,50,14.2,85.8
4,0,2,123,-3,426,511,85,16.6,83.4
4,0,2,123,-2,524,697,173,24.8,75.2
4,0,2,123,-1,594,908,314,34.6,65.4
4,0,2,123,0,522,1005,483,48.1,51.9
4,0,2,123,1,248,614,366,59.6,40.4
4,0,2,123,2,107,390,283,72.6,27.4
4,0,2,123,3,47,275,228,82.9,17.1
4,0,2,123,4,16,163,147,90.2,9.8
4,0,2,123,5,9,74,65,87.8,12.2
4,0,2,123,6,0,40,40,100,0
4,0,2,123,7,1,18,17,94.4,5.60000000000001
4,0,2,123,8,0,8,8,100,0
4,0,2,123,9,0,5,5,100,0
4,0,2,123,10,0,2,2,100,0
4,0,2,123,11,0,1,1,100,0
4,0,2,123,12,0,1,1,100,0
4,0,2,123,13,0,1,1,100,0
4,1,0,0,-19,1,1,0,0,100
4,1,0,0,-17,2,2,0,0,100
4,1,0,0,-16,2,2,0,0,100
4,1,0,0,-15,4,4,0,0,100
4,1,0,0,-14,9,9,0,0,100
4,1,0,0,-13,26,26,0,0,100
4,1,0,0,-12,61,62,1,1.6,98.4
4,1,0,0,-11,90,92,2,2.2,97.8
4,1,0,0,-10,197,199,2,1,99
4,1,0,0,-9,376,383,7,1.8,98.2
4,1,0,0,-8,625,642,17,2.6,97.4
4,1,0,0,-7,1102,1136,34,3,97
4,1,0,0,-6,1852,1986,134,6.7,93.3
4,1,0,0,-5,3066,3378,312,9.2,90.8
4,1,0,0,-4,4981,5797,816,14.1,85.9
4,1,0,0,-3,7399,9465,2066,21.8,78.2
4,1,0,0,-2,10206,14754,4548,30.8,69.2
4,1,0,0,-1,11787,20888,9101,43.6,56.4
4,1,0,0,0,12004,28453,16449,57.8,42.2
4,1,0,0,1,5286,18388,13102,71.3,28.7
4,1,0,0,2,2225,12032,9807,81.5,18.5
4,1,0,0,3,907,7745,6838,88.3,11.7
4,1,0,0,4,322,4636,4314,93.1,6.89999999999999
4,1,0,0,5,103,2647,2544,96.1,3.90000000000001
4,1,0,0,6,39,1408,1369,97.2,2.8
4,1,0,0,7,12,743,731,98.4,1.59999999999999
4,1,0,0,8,6,392,386,98.5,1.5
4,1,0,0,9,1,208,207,99.5,0.5
4,1,0,0,10,1,102,101,99,1
4,1,0,0,11,2,62,60,96.8,3.2
4,1,0,0,12,0,28,28,100,0
4,1,0,0,13,0,20,20,100,0
4,1,0,0,14,0,4,4,100,0
4,1,0,0,15,0,4,4,100,0
4,1,0,0,16,0,1,1,100,0
4,1,0,0,17,0,2,2,100,0
4,1,0,1,-19,1,1,0,0,100
4,1,0,1,-15,1,1,0,0,100
4,1,0,1,-14,1,1,0,0,100
4,1,0,1,-13,7,7,0,0,100
4,1,0,1,-12,8,9,1,11.1,88.9
4,1,0,1,-11,17,18,1,5.6,94.4
4,1,0,1,-10,47,48,1,2.1,97.9
4,1,0,1,-9,94,98,4,4.1,95.9
4,1,0,1,-8,147,154,7,4.5,95.5
4,1,0,1,-7,268,278,10,3.6,96.4
4,1,0,1,-6,436,482,46,9.5,90.5
4,1,0,1,-5,815,914,99,10.8,89.2
4,1,0,1,-4,1237,1522,285,18.7,81.3
4,1,0,1,-3,1768,2415,647,26.8,73.2
4,1,0,1,-2,2503,3846,1343,34.9,65.1
4,1,0,1,-1,2733,5423,2690,49.6,50.4
4,1,0,1,0,2804,7451,4647,62.4,37.6
4,1,0,1,1,1228,4871,3643,74.8,25.2
4,1,0,1,2,521,3090,2569,83.1,16.9
4,1,0,1,3,194,2039,1845,90.5,9.5
4,1,0,1,4,66,1249,1183,94.7,5.30000000000001
4,1,0,1,5,18,741,723,97.6,2.40000000000001
4,1,0,1,6,10,390,380,97.4,2.60000000000001
4,1,0,1,7,2,229,227,99.1,0.900000000000006
4,1,0,1,8,0,137,137,100,0
4,1,0,1,9,0,55,55,100,0
4,1,0,1,10,0,32,32,100,0
4,1,0,1,11,0,22,22,100,0
4,1,0,1,12,0,3,3,100,0
4,1,0,1,13,0,5,5,100,0
4,1,0,1,14,0,1,1,100,0
4,1,0,1,15,0,1,1,100,0
4,1,0,2,-13,2,2,0,0,100
4,1,0,2,-12,7,7,0,0,100
4,1,0,2,-11,5,5,0,0,100
4,1,0,2,-10,13,13,0,0,100
4,1,0,2,-9,27,27,0,0,100
4,1,0,2,-8,40,42,2,4.8,95.2
4,1,0,2,-7,68,72,4,5.6,94.4
4,1,0,2,-6,127,139,12,8.6,91.4
4,1,0,2,-5,194,224,30,13.4,86.6
4,1,0,2,-4,296,374,78,20.9,79.1
4,1,0,2,-3,427,594,167,28.1,71.9
4,1,0,2,-2,612,1008,396,39.3,60.7
4,1,0,2,-1,766,1592,826,51.9,48.1
4,1,0,2,0,748,2158,1410,65.3,34.7
4,1,0,2,1,339,1525,1186,77.8,22.2
4,1,0,2,2,175,1026,851,82.9,17.1
4,1,0,2,3,58,628,570,90.8,9.2
4,1,0,2,4,21,406,385,94.8,5.2
4,1,0,2,5,5,296,291,98.3,1.7
4,1,0,2,6,4,140,136,97.1,2.90000000000001
4,1,0,2,7,2,75,73,97.3,2.7
4,1,0,2,8,0,34,34,100,0
4,1,0,2,9,0,19,19,100,0
4,1,0,2,10,0,9,9,100,0
4,1,0,2,11,0,3,3,100,0
4,1,0,2,12,0,1,1,100,0
4,1,0,2,13,0,1,1,100,0
4,1,0,2,14,0,2,2,100,0
4,1,0,2,15,0,1,1,100,0
4,1,0,12,-15,1,1,0,0,100
4,1,0,12,-13,2,2,0,0,100
4,1,0,12,-11,5,6,1,16.7,83.3
4,1,0,12,-10,13,13,0,0,100
4,1,0,12,-9,21,23,2,8.7,91.3
4,1,0,12,-8,31,34,3,8.8,91.2
4,1,0,12,-7,72,78,6,7.7,92.3
4,1,0,12,-6,114,129,15,11.6,88.4
4,1,0,12,-5,192,228,36,15.8,84.2
4,1,0,12,-4,267,375,108,28.8,71.2
4,1,0,12,-3,394,574,180,31.4,68.6
4,1,0,12,-2,524,906,382,42.2,57.8
4,1,0,12,-1,510,1236,726,58.7,41.3
4,1,0,12,0,534,1709,1175,68.8,31.2
4,1,0,12,1,244,1169,925,79.1,20.9
4,1,0,12,2,98,801,703,87.8,12.2
4,1,0,12,3,37,460,423,92,8
4,1,0,12,4,11,316,305,96.5,3.5
4,1,0,12,5,2,189,187,98.9,1.09999999999999
4,1,0,12,6,1,128,127,99.2,0.799999999999997
4,1,0,12,7,1,90,89,98.9,1.09999999999999
4,1,0,12,8,0,41,41,100,0
4,1,0,12,9,0,25,25,100,0
4,1,0,12,10,0,13,13,100,0
4,1,0,12,11,0,9,9,100,0
4,1,0,12,12,0,2,2,100,0
4,1,0,12,13,0,1,1,100,0
4,1,0,12,14,0,1,1,100,0
4,1,0,3,-12,1,1,0,0,100
4,1,0,3,-9,5,5,0,0,100
4,1,0,3,-8,4,4,0,0,100
4,1,0,3,-7,11,11,0,0,100
4,1,0,3,-6,17,18,1,5.6,94.4
4,1,0,3,-5,29,31,2,6.5,93.5
4,1,0,3,-4,44,63,19,30.2,69.8
4,1,0,3,-3,78,104,26,25,75
4,1,0,3,-2,108,181,73,40.3,59.7
4,1,0,3,-1,132,292,160,54.8,45.2
4,1,0,3,0,128,392,264,67.3,32.7
4,1,0,3,1,60,317,257,81.1,18.9
4,1,0,3,2,27,208,181,87,13
4,1,0,3,3,16,171,155,90.6,9.39999999999999
4,1,0,3,4,2,96,94,97.9,2.10000000000001
4,1,0,3,5,1,60,59,98.3,1.7
4,1,0,3,6,0,37,37,100,0
4,1,0,3,7,0,16,16,100,0
4,1,0,3,8,0,8,8,100,0
4,1,0,3,9,0,6,6,100,0
4,1,0,3,10,0,3,3,100,0
4,1,0,3,11,0,2,2,100,0
4,1,0,13,-12,1,1,0,0,100
4,1,0,13,-11,2,2,0,0,100
4,1,0,13,-10,3,4,1,25,75
4,1,0,13,-9,6,7,1,14.3,85.7
4,1,0,13,-8,8,9,1,11.1,88.9
4,1,0,13,-7,15,16,1,6.2,93.8
4,1,0,13,-6,39,43,4,9.3,90.7
4,1,0,13,-5,47,59,12,20.3,79.7
4,1,0,13,-4,92,123,31,25.2,74.8
4,1,0,13,-3,137,209,72,34.4,65.6
4,1,0,13,-2,170,330,160,48.5,51.5
4,1,0,13,-1,225,527,302,57.3,42.7
4,1,0,13,0,218,766,548,71.5,28.5
4,1,0,13,1,110,575,465,80.9,19.1
4,1,0,13,2,40,354,314,88.7,11.3
4,1,0,13,3,15,246,231,93.9,6.10000000000001
4,1,0,13,4,3,140,137,97.9,2.10000000000001
4,1,0,13,5,3,93,90,96.8,3.2
4,1,0,13,6,2,59,57,96.6,3.40000000000001
4,1,0,13,7,0,33,33,100,0
4,1,0,13,8,0,19,19,100,0
4,1,0,13,9,0,16,16,100,0
4,1,0,13,10,0,3,3,100,0
4,1,0,13,11,0,2,2,100,0
4,1,0,23,-11,1,1,0,0,100
4,1,0,23,-9,2,2,0,0,100
4,1,0,23,-8,8,8,0,0,100
4,1,0,23,-7,12,13,1,7.7,92.3
4,1,0,23,-6,28,34,6,17.6,82.4
4,1,0,23,-5,35,45,10,22.2,77.8
4,1,0,23,-4,67,92,25,27.2,72.8
4,1,0,23,-3,82,138,56,40.6,59.4
4,1,0,23,-2,109,202,93,46,54
4,1,0,23,-1,104,290,186,64.1,35.9
4,1,0,23,0,91,399,308,77.2,22.8
4,1,0,23,1,55,346,291,84.1,15.9
4,1,0,23,2,9,200,191,95.5,4.5
4,1,0,23,3,8,123,115,93.5,6.5
4,1,0,23,4,4,93,89,95.7,4.3
4,1,0,23,5,3,58,55,94.8,5.2
4,1,0,23,6,0,47,47,100,0
4,1,0,23,7,0,12,12,100,0
4,1,0,23,8,0,18,18,100,0
4,1,0,23,9,0,9,9,100,0
4,1,0,23,10,0,2,2,100,0
4,1,0,23,11,0,1,1,100,0
4,1,0,23,12,0,2,2,100,0
4,1,0,123,-10,3,4,1,25,75
4,1,0,123,-9,6,7,1,14.3,85.7
4,1,0,123,-8,5,6,1,16.7,83.3
4,1,0,123,-7,16,16,0,0,100
4,1,0,123,-6,30,30,0,0,100
4,1,0,123,-5,41,48,7,14.6,85.4
4,1,0,123,-4,67,92,25,27.2,72.8
4,1,0,123,-3,73,128,55,43,57
4,1,0,123,-2,97,197,100,50.8,49.2
4,1,0,123,-1,102,279,177,63.4,36.6
4,1,0,123,0,91,386,295,76.4,23.6
4,1,0,123,1,42,279,237,84.9,15.1
4,1,0,123,2,12,210,198,94.3,5.7
4,1,0,123,3,7,139,132,95,5
4,1,0,123,4,2,97,95,97.9,2.10000000000001
4,1,0,123,5,1,71,70,98.6,1.40000000000001
4,1,0,123,6,0,42,42,100,0
4,1,0,123,7,0,31,31,100,0
4,1,0,123,8,0,12,12,100,0
4,1,0,123,9,0,9,9,100,0
4,1,0,123,10,0,4,4,100,0
4,1,0,123,11,0,2,2,100,0
4,1,0,123,12,0,1,1,100,0
4,1,1,0,-17,1,1,0,0,100
4,1,1,0,-16,2,2,0,0,100
4,1,1,0,-15,3,3,0,0,100
4,1,1,0,-14,8,8,0,0,100
4,1,1,0,-13,15,15,0,0,100
4,1,1,0,-12,45,45,0,0,100
4,1,1,0,-11,69,70,1,1.4,98.6
4,1,1,0,-10,133,134,1,0.7,99.3
4,1,1,0,-9,252,255,3,1.2,98.8
4,1,1,0,-8,432,442,10,2.3,97.7
4,1,1,0,-7,768,786,18,2.3,97.7
4,1,1,0,-6,1296,1365,69,5.1,94.9
4,1,1,0,-5,2062,2244,182,8.1,91.9
4,1,1,0,-4,3475,3911,436,11.1,88.9
4,1,1,0,-3,5264,6472,1208,18.7,81.3
4,1,1,0,-2,7287,10086,2799,27.8,72.2
4,1,1,0,-1,8586,14282,5696,39.9,60.1
4,1,1,0,0,8885,19604,10719,54.7,45.3
4,1,1,0,1,4113,13154,9041,68.7,31.3
4,1,1,0,2,1773,8997,7224,80.3,19.7
4,1,1,0,3,752,5755,5003,86.9,13.1
4,1,1,0,4,277,3498,3221,92.1,7.89999999999999
4,1,1,0,5,96,1957,1861,95.1,4.90000000000001
4,1,1,0,6,29,1093,1064,97.3,2.7
4,1,1,0,7,12,577,565,97.9,2.10000000000001
4,1,1,0,8,7,319,312,97.8,2.2
4,1,1,0,9,3,198,195,98.5,1.5
4,1,1,0,10,0,95,95,100,0
4,1,1,0,11,2,53,51,96.2,3.8
4,1,1,0,12,0,32,32,100,0
4,1,1,0,13,0,15,15,100,0
4,1,1,0,14,0,3,3,100,0
4,1,1,0,15,0,3,3,100,0
4,1,1,0,16,0,1,1,100,0
4,1,1,0,17,0,2,2,100,0
4,1,1,1,-19,1,1,0,0,100
4,1,1,1,-16,1,1,0,0,100
4,1,1,1,-15,1,1,0,0,100
4,1,1,1,-14,3,3,0,0,100
4,1,1,1,-13,7,7,0,0,100
4,1,1,1,-12,14,14,0,0,100
4,1,1,1,-11,26,26,0,0,100
4,1,1,1,-10,58,59,1,1.7,98.3
4,1,1,1,-9,114,115,1,0.9,99.1
4,1,1,1,-8,188,194,6,3.1,96.9
4,1,1,1,-7,311,323,12,3.7,96.3
4,1,1,1,-6,491,528,37,7,93
4,1,1,1,-5,883,982,99,10.1,89.9
4,1,1,1,-4,1461,1703,242,14.2,85.8
4,1,1,1,-3,2105,2733,628,23,77
4,1,1,1,-2,3015,4338,1323,30.5,69.5
4,1,1,1,-1,3340,5883,2543,43.2,56.8
4,1,1,1,0,3357,7934,4577,57.7,42.3
4,1,1,1,1,1618,5693,4075,71.6,28.4
4,1,1,1,2,713,3918,3205,81.8,18.2
4,1,1,1,3,263,2433,2170,89.2,10.8
4,1,1,1,4,106,1478,1372,92.8,7.19999999999999
4,1,1,1,5,35,947,912,96.3,3.7
4,1,1,1,6,11,503,492,97.8,2.2
4,1,1,1,7,8,304,296,97.4,2.60000000000001
4,1,1,1,8,2,172,170,98.8,1.2
4,1,1,1,9,0,86,86,100,0
4,1,1,1,10,0,49,49,100,0
4,1,1,1,11,0,30,30,100,0
4,1,1,1,12,0,15,15,100,0
4,1,1,1,13,0,7,7,100,0
4,1,1,1,14,0,2,2,100,0
4,1,1,1,15,0,4,4,100,0
4,1,1,1,17,0,1,1,100,0
4,1,1,2,-13,4,4,0,0,100
4,1,1,2,-12,8,8,0,0,100
4,1,1,2,-11,4,5,1,20,80
4,1,1,2,-10,21,21,0,0,100
4,1,1,2,-9,40,41,1,2.4,97.6
4,1,1,2,-8,65,65,0,0,100
4,1,1,2,-7,99,105,6,5.7,94.3
4,1,1,2,-6,176,189,13,6.9,93.1
4,1,1,2,-5,309,347,38,11,89
4,1,1,2,-4,449,535,86,16.1,83.9
4,1,1,2,-3,693,953,260,27.3,72.7
4,1,1,2,-2,1018,1514,496,32.8,67.2
4,1,1,2,-1,1320,2463,1143,46.4,53.6
4,1,1,2,0,1383,3461,2078,60,40
4,1,1,2,1,718,2628,1910,72.7,27.3
4,1,1,2,2,375,1950,1575,80.8,19.2
4,1,1,2,3,142,1375,1233,89.7,10.3
4,1,1,2,4,55,830,775,93.4,6.59999999999999
4,1,1,2,5,13,566,553,97.7,2.3
4,1,1,2,6,7,280,273,97.5,2.5
4,1,1,2,7,1,154,153,99.4,0.599999999999994
4,1,1,2,8,0,77,77,100,0
4,1,1,2,9,0,40,40,100,0
4,1,1,2,10,0,20,20,100,0
4,1,1,2,11,0,11,11,100,0
4,1,1,2,12,0,4,4,100,0
4,1,1,2,14,0,2,2,100,0
4,1,1,2,15,0,3,3,100,0
4,1,1,2,16,0,1,1,100,0
4,1,1,12,-16,1,1,0,0,100
4,1,1,12,-14,2,2,0,0,100
4,1,1,12,-13,6,6,0,0,100
4,1,1,12,-12,7,7,0,0,100
4,1,1,12,-11,8,8,0,0,100
4,1,1,12,-10,14,14,0,0,100
4,1,1,12,-9,47,48,1,2.1,97.9
4,1,1,12,-8,74,78,4,5.1,94.9
4,1,1,12,-7,114,122,8,6.6,93.4
4,1,1,12,-6,180,204,24,11.8,88.2
4,1,1,12,-5,321,367,46,12.5,87.5
4,1,1,12,-4,442,548,106,19.3,80.7
4,1,1,12,-3,651,908,257,28.3,71.7
4,1,1,12,-2,923,1417,494,34.9,65.1
4,1,1,12,-1,952,1948,996,51.1,48.9
4,1,1,12,0,1019,2654,1635,61.6,38.4
4,1,1,12,1,500,2062,1562,75.8,24.2
4,1,1,12,2,229,1494,1265,84.7,15.3
4,1,1,12,3,106,935,829,88.7,11.3
4,1,1,12,4,32,583,551,94.5,5.5
4,1,1,12,5,9,443,434,98,2
4,1,1,12,6,5,233,228,97.9,2.10000000000001
4,1,1,12,7,2,160,158,98.8,1.2
4,1,1,12,8,0,92,92,100,0
4,1,1,12,9,0,47,47,100,0
4,1,1,12,10,0,23,23,100,0
4,1,1,12,11,0,11,11,100,0
4,1,1,12,12,0,6,6,100,0
4,1,1,12,13,0,2,2,100,0
4,1,1,12,15,0,3,3,100,0
4,1,1,12,16,0,1,1,100,0
4,1,1,12,18,0,1,1,100,0
4,1,1,3,-13,1,1,0,0,100
4,1,1,3,-12,1,1,0,0,100
4,1,1,3,-11,3,3,0,0,100
4,1,1,3,-10,3,3,0,0,100
4,1,1,3,-9,14,14,0,0,100
4,1,1,3,-8,15,15,0,0,100
4,1,1,3,-7,24,25,1,4,96
4,1,1,3,-6,51,54,3,5.6,94.4
4,1,1,3,-5,82,93,11,11.8,88.2
4,1,1,3,-4,137,170,33,19.4,80.6
4,1,1,3,-3,206,287,81,28.2,71.8
4,1,1,3,-2,288,496,208,41.9,58.1
4,1,1,3,-1,438,850,412,48.5,51.5
4,1,1,3,0,425,1165,740,63.5,36.5
4,1,1,3,1,230,977,747,76.5,23.5
4,1,1,3,2,115,755,640,84.8,15.2
4,1,1,3,3,48,506,458,90.5,9.5
4,1,1,3,4,15,376,361,96,4
4,1,1,3,5,5,189,184,97.4,2.60000000000001
4,1,1,3,6,0,116,116,100,0
4,1,1,3,7,1,53,52,98.1,1.90000000000001
4,1,1,3,8,0,34,34,100,0
4,1,1,3,9,0,14,14,100,0
4,1,1,3,10,0,8,8,100,0
4,1,1,3,11,0,5,5,100,0
4,1,1,3,12,0,1,1,100,0
4,1,1,3,13,0,2,2,100,0
4,1,1,13,-18,1,1,0,0,100
4,1,1,13,-15,1,1,0,0,100
4,1,1,13,-14,1,1,0,0,100
4,1,1,13,-13,2,2,0,0,100
4,1,1,13,-12,2,2,0,0,100
4,1,1,13,-11,4,4,0,0,100
4,1,1,13,-10,5,5,0,0,100
4,1,1,13,-9,7,8,1,12.5,87.5
4,1,1,13,-8,28,28,0,0,100
4,1,1,13,-7,37,43,6,14,86
4,1,1,13,-6,71,74,3,4.1,95.9
4,1,1,13,-5,112,134,22,16.4,83.6
4,1,1,13,-4,180,234,54,23.1,76.9
4,1,1,13,-3,265,387,122,31.5,68.5
4,1,1,13,-2,385,611,226,37,63
4,1,1,13,-1,444,945,501,53,47
4,1,1,13,0,431,1280,849,66.3,33.7
4,1,1,13,1,247,1075,828,77,23
4,1,1,13,2,121,804,683,85,15
4,1,1,13,3,44,511,467,91.4,8.59999999999999
4,1,1,13,4,18,362,344,95,5
4,1,1,13,5,5,238,233,97.9,2.10000000000001
4,1,1,13,6,0,140,140,100,0
4,1,1,13,7,1,86,85,98.8,1.2
4,1,1,13,8,0,34,34,100,0
4,1,1,13,9,0,20,20,100,0
4,1,1,13,10,0,10,10,100,0
4,1,1,13,11,0,6,6,100,0
4,1,1,13,12,0,2,2,100,0
4,1,1,13,13,0,1,1,100,0
4,1,1,23,-19,1,1,0,0,100
4,1,1,23,-15,1,1,0,0,100
4,1,1,23,-12,1,1,0,0,100
4,1,1,23,-11,3,3,0,0,100
4,1,1,23,-10,1,1,0,0,100
4,1,1,23,-9,10,11,1,9.1,90.9
4,1,1,23,-8,10,10,0,0,100
4,1,1,23,-7,18,19,1,5.3,94.7
4,1,1,23,-6,59,68,9,13.2,86.8
4,1,1,23,-5,80,93,13,14,86
4,1,1,23,-4,123,154,31,20.1,79.9
4,1,1,23,-3,174,242,68,28.1,71.9
4,1,1,23,-2,242,425,183,43.1,56.9
4,1,1,23,-1,254,614,360,58.6,41.4
4,1,1,23,0,268,922,654,70.9,29.1
4,1,1,23,1,161,798,637,79.8,20.2
4,1,1,23,2,84,623,539,86.5,13.5
4,1,1,23,3,30,390,360,92.3,7.69999999999999
4,1,1,23,4,10,269,259,96.3,3.7
4,1,1,23,5,3,162,159,98.1,1.90000000000001
4,1,1,23,6,0,102,102,100,0
4,1,1,23,7,1,56,55,98.2,1.8
4,1,1,23,8,0,36,36,100,0
4,1,1,23,9,0,19,19,100,0
4,1,1,23,10,0,10,10,100,0
4,1,1,23,11,0,5,5,100,0
4,1,1,23,12,0,2,2,100,0
4,1,1,23,14,0,1,1,100,0
4,1,1,23,15,0,2,2,100,0
4,1,1,123,-14,1,1,0,0,100
4,1,1,123,-12,1,1,0,0,100
4,1,1,123,-11,3,3,0,0,100
4,1,1,123,-10,2,2,0,0,100
4,1,1,123,-9,13,13,0,0,100
4,1,1,123,-8,21,22,1,4.5,95.5
4,1,1,123,-7,31,34,3,8.8,91.2
4,1,1,123,-6,46,60,14,23.3,76.7
4,1,1,123,-5,75,101,26,25.7,74.3
4,1,1,123,-4,116,155,39,25.2,74.8
4,1,1,123,-3,143,231,88,38.1,61.9
4,1,1,123,-2,200,359,159,44.3,55.7
4,1,1,123,-1,236,597,361,60.5,39.5
4,1,1,123,0,275,895,620,69.3,30.7
4,1,1,123,1,171,765,594,77.6,22.4
4,1,1,123,2,69,605,536,88.6,11.4
4,1,1,123,3,29,403,374,92.8,7.19999999999999
4,1,1,123,4,9,249,240,96.4,3.60000000000001
4,1,1,123,5,4,198,194,98,2
4,1,1,123,6,1,111,110,99.1,0.900000000000006
4,1,1,123,7,1,72,71,98.6,1.40000000000001
4,1,1,123,8,0,39,39,100,0
4,1,1,123,9,0,20,20,100,0
4,1,1,123,10,0,11,11,100,0
4,1,1,123,11,0,2,2,100,0
4,1,1,123,12,0,3,3,100,0
4,1,1,123,13,0,2,2,100,0
4,1,1,123,15,0,1,1,100,0
4,1,1,123,16,0,1,1,100,0
4,1,2,0,-17,1,1,0,0,100
4,1,2,0,-16,1,1,0,0,100
4,1,2,0,-15,2,2,0,0,100
4,1,2,0,-14,6,6,0,0,100
4,1,2,0,-13,8,8,0,0,100
4,1,2,0,-12,32,32,0,0,100
4,1,2,0,-11,49,49,0,0,100
4,1,2,0,-10,96,96,0,0,100
4,1,2,0,-9,179,181,2,1.1,98.9
4,1,2,0,-8,308,315,7,2.2,97.8
4,1,2,0,-7,565,576,11,1.9,98.1
4,1,2,0,-6,975,1013,38,3.8,96.2
4,1,2,0,-5,1568,1668,100,6,94
4,1,2,0,-4,2606,2878,272,9.5,90.5
4,1,2,0,-3,4048,4830,782,16.2,83.8
4,1,2,0,-2,5639,7576,1937,25.6,74.4
4,1,2,0,-1,6765,10846,4081,37.6,62.4
4,1,2,0,0,7182,15114,7932,52.5,47.5
4,1,2,0,1,3494,10678,7184,67.3,32.7
4,1,2,0,2,1565,7379,5814,78.8,21.2
4,1,2,0,3,681,4986,4305,86.3,13.7
4,1,2,0,4,249,3082,2833,91.9,8.09999999999999
4,1,2,0,5,88,1801,1713,95.1,4.90000000000001
4,1,2,0,6,38,1051,1013,96.4,3.60000000000001
4,1,2,0,7,9,623,614,98.6,1.40000000000001
4,1,2,0,8,5,374,369,98.7,1.3
4,1,2,0,9,3,199,196,98.5,1.5
4,1,2,0,10,0,101,101,100,0
4,1,2,0,11,2,60,58,96.7,3.3
4,1,2,0,12,0,34,34,100,0
4,1,2,0,13,0,21,21,100,0
4,1,2,0,14,0,6,6,100,0
4,1,2,0,16,0,2,2,100,0
4,1,2,0,17,0,1,1,100,0
4,1,2,0,18,0,1,1,100,0
4,1,2,1,-14,3,3,0,0,100
4,1,2,1,-13,6,6,0,0,100
4,1,2,1,-12,14,14,0,0,100
4,1,2,1,-11,20,20,0,0,100
4,1,2,1,-10,57,58,1,1.7,98.3
4,1,2,1,-9,96,96,0,0,100
4,1,2,1,-8,173,176,3,1.7,98.3
4,1,2,1,-7,300,308,8,2.6,97.4
4,1,2,1,-6,500,522,22,4.2,95.8
4,1,2,1,-5,808,877,69,7.9,92.1
4,1,2,1,-4,1418,1575,157,10,90
4,1,2,1,-3,2068,2509,441,17.6,82.4
4,1,2,1,-2,2887,4029,1142,28.3,71.7
4,1,2,1,-1,3357,5459,2102,38.5,61.5
4,1,2,1,0,3466,7654,4188,54.7,45.3
4,1,2,1,1,1796,5802,4006,69,31
4,1,2,1,2,805,3973,3168,79.7,20.3
4,1,2,1,3,342,2817,2475,87.9,12.1
4,1,2,1,4,143,1824,1681,92.2,7.8
4,1,2,1,5,53,1156,1103,95.4,4.60000000000001
4,1,2,1,6,18,715,697,97.5,2.5
4,1,2,1,7,6,416,410,98.6,1.40000000000001
4,1,2,1,8,2,252,250,99.2,0.799999999999997
4,1,2,1,9,1,127,126,99.2,0.799999999999997
4,1,2,1,10,0,85,85,100,0
4,1,2,1,11,0,43,43,100,0
4,1,2,1,12,0,23,23,100,0
4,1,2,1,13,0,15,15,100,0
4,1,2,1,14,0,4,4,100,0
4,1,2,1,15,0,1,1,100,0
4,1,2,1,17,0,2,2,100,0
4,1,2,1,18,0,1,1,100,0
4,1,2,2,-13,2,2,0,0,100
4,1,2,2,-12,8,8,0,0,100
4,1,2,2,-11,7,7,0,0,100
4,1,2,2,-10,22,22,0,0,100
4,1,2,2,-9,36,36,0,0,100
4,1,2,2,-8,68,70,2,2.9,97.1
4,1,2,2,-7,125,129,4,3.1,96.9
4,1,2,2,-6,200,212,12,5.7,94.3
4,1,2,2,-5,316,345,29,8.4,91.6
4,1,2,2,-4,516,588,72,12.2,87.8
4,1,2,2,-3,842,1060,218,20.6,79.4
4,1,2,2,-2,1257,1784,527,29.5,70.5
4,1,2,2,-1,1660,2811,1151,40.9,59.1
4,1,2,2,0,1758,3988,2230,55.9,44.1
4,1,2,2,1,1033,3463,2430,70.2,29.8
4,1,2,2,2,534,2685,2151,80.1,19.9
4,1,2,2,3,242,2013,1771,88,12
4,1,2,2,4,106,1297,1191,91.8,8.2
4,1,2,2,5,26,781,755,96.7,3.3
4,1,2,2,6,10,461,451,97.8,2.2
4,1,2,2,7,5,276,271,98.2,1.8
4,1,2,2,8,2,118,116,98.3,1.7
4,1,2,2,9,0,84,84,100,0
4,1,2,2,10,0,49,49,100,0
4,1,2,2,11,0,28,28,100,0
4,1,2,2,12,0,12,12,100,0
4,1,2,2,13,0,1,1,100,0
4,1,2,2,14,0,6,6,100,0
4,1,2,2,15,0,3,3,100,0
4,1,2,2,16,0,2,2,100,0
4,1,2,2,17,0,2,2,100,0
4,1,2,12,-16,1,1,0,0,100
4,1,2,12,-13,4,4,0,0,100
4,1,2,12,-12,8,8,0,0,100
4,1,2,12,-11,8,8,0,0,100
4,1,2,12,-10,25,25,0,0,100
4,1,2,12,-9,38,39,1,2.6,97.4
4,1,2,12,-8,62,64,2,3.1,96.9
4,1,2,12,-7,122,125,3,2.4,97.6
4,1,2,12,-6,209,218,9,4.1,95.9
4,1,2,12,-5,355,378,23,6.1,93.9
4,1,2,12,-4,557,626,69,11,89
4,1,2,12,-3,768,990,222,22.4,77.6
4,1,2,12,-2,1151,1619,468,28.9,71.1
4,1,2,12,-1,1280,2267,987,43.5,56.5
4,1,2,12,0,1360,3196,1836,57.4,42.6
4,1,2,12,1,822,2801,1979,70.7,29.3
4,1,2,12,2,364,2043,1679,82.2,17.8
4,1,2,12,3,157,1434,1277,89.1,10.9
4,1,2,12,4,65,890,825,92.7,7.3
4,1,2,12,5,23,592,569,96.1,3.90000000000001
4,1,2,12,6,10,389,379,97.4,2.60000000000001
4,1,2,12,7,7,260,253,97.3,2.7
4,1,2,12,8,2,135,133,98.5,1.5
4,1,2,12,9,0,81,81,100,0
4,1,2,12,10,0,51,51,100,0
4,1,2,12,11,0,29,29,100,0
4,1,2,12,12,0,13,13,100,0
4,1,2,12,13,0,8,8,100,0
4,1,2,12,14,0,6,6,100,0
4,1,2,12,15,0,3,3,100,0
4,1,2,12,17,0,1,1,100,0
4,1,2,3,-13,1,1,0,0,100
4,1,2,3,-12,1,1,0,0,100
4,1,2,3,-11,4,5,1,20,80
4,1,2,3,-10,16,16,0,0,100
4,1,2,3,-9,17,17,0,0,100
4,1,2,3,-8,26,26,0,0,100
4,1,2,3,-7,44,46,2,4.3,95.7
4,1,2,3,-6,74,76,2,2.6,97.4
4,1,2,3,-5,148,162,14,8.6,91.4
4,1,2,3,-4,210,250,40,16,84
4,1,2,3,-3,354,434,80,18.4,81.6
4,1,2,3,-2,484,699,215,30.8,69.2
4,1,2,3,-1,646,1102,456,41.4,58.6
4,1,2,3,0,709,1590,881,55.4,44.6
4,1,2,3,1,411,1416,1005,71,29
4,1,2,3,2,217,1083,866,80,20
4,1,2,3,3,100,768,668,87,13
4,1,2,3,4,45,524,479,91.4,8.59999999999999
4,1,2,3,5,12,353,341,96.6,3.40000000000001
4,1,2,3,6,5,214,209,97.7,2.3
4,1,2,3,7,2,99,97,98,2
4,1,2,3,8,0,75,75,100,0
4,1,2,3,9,0,39,39,100,0
4,1,2,3,10,0,16,16,100,0
4,1,2,3,11,0,10,10,100,0
4,1,2,3,12,0,6,6,100,0
4,1,2,3,13,0,3,3,100,0
4,1,2,3,14,0,1,1,100,0
4,1,2,3,15,0,1,1,100,0
4,1,2,13,-18,1,1,0,0,100
4,1,2,13,-13,1,1,0,0,100
4,1,2,13,-12,1,1,0,0,100
4,1,2,13,-11,4,4,0,0,100
4,1,2,13,-10,7,7,0,0,100
4,1,2,13,-9,13,14,1,7.1,92.9
4,1,2,13,-8,25,26,1,3.8,96.2
4,1,2,13,-7,51,53,2,3.8,96.2
4,1,2,13,-6,88,92,4,4.3,95.7
4,1,2,13,-5,135,146,11,7.5,92.5
4,1,2,13,-4,225,268,43,16,84
4,1,2,13,-3,377,465,88,18.9,81.1
4,1,2,13,-2,470,709,239,33.7,66.3
4,1,2,13,-1,543,987,444,45,55
4,1,2,13,0,643,1532,889,58,42
4,1,2,13,1,370,1307,937,71.7,28.3
4,1,2,13,2,210,1071,861,80.4,19.6
4,1,2,13,3,78,742,664,89.5,10.5
4,1,2,13,4,41,535,494,92.3,7.69999999999999
4,1,2,13,5,18,335,317,94.6,5.40000000000001
4,1,2,13,6,3,202,199,98.5,1.5
4,1,2,13,7,1,148,147,99.3,0.700000000000003
4,1,2,13,8,2,90,88,97.8,2.2
4,1,2,13,9,0,43,43,100,0
4,1,2,13,10,0,28,28,100,0
4,1,2,13,11,0,11,11,100,0
4,1,2,13,12,0,4,4,100,0
4,1,2,13,13,0,4,4,100,0
4,1,2,13,15,0,1,1,100,0
4,1,2,13,16,0,2,2,100,0
4,1,2,13,18,0,1,1,100,0
4,1,2,23,-15,1,1,0,0,100
4,1,2,23,-14,1,1,0,0,100
4,1,2,23,-13,1,1,0,0,100
4,1,2,23,-12,1,1,0,0,100
4,1,2,23,-11,1,1,0,0,100
4,1,2,23,-10,4,5,1,20,80
4,1,2,23,-9,12,13,1,7.7,92.3
4,1,2,23,-8,15,15,0,0,100
4,1,2,23,-7,28,28,0,0,100
4,1,2,23,-6,58,62,4,6.5,93.5
4,1,2,23,-5,75,84,9,10.7,89.3
4,1,2,23,-4,122,144,22,15.3,84.7
4,1,2,23,-3,195,251,56,22.3,77.7
4,1,2,23,-2,271,418,147,35.2,64.8
4,1,2,23,-1,335,587,252,42.9,57.1
4,1,2,23,0,349,914,565,61.8,38.2
4,1,2,23,1,205,883,678,76.8,23.2
4,1,2,23,2,128,718,590,82.2,17.8
4,1,2,23,3,57,506,449,88.7,11.3
4,1,2,23,4,29,370,341,92.2,7.8
4,1,2,23,5,7,210,203,96.7,3.3
4,1,2,23,6,3,133,130,97.7,2.3
4,1,2,23,7,0,82,82,100,0
4,1,2,23,8,0,43,43,100,0
4,1,2,23,9,0,30,30,100,0
4,1,2,23,10,0,8,8,100,0
4,1,2,23,11,0,7,7,100,0
4,1,2,23,12,0,4,4,100,0
4,1,2,23,13,0,1,1,100,0
4,1,2,23,15,0,2,2,100,0
4,1,2,123,-14,1,1,0,0,100
4,1,2,123,-13,1,1,0,0,100
4,1,2,123,-12,1,1,0,0,100
4,1,2,123,-11,3,3,0,0,100
4,1,2,123,-10,3,3,0,0,100
4,1,2,123,-9,13,14,1,7.1,92.9
4,1,2,123,-8,18,18,0,0,100
4,1,2,123,-7,34,36,2,5.6,94.4
4,1,2,123,-6,39,43,4,9.3,90.7
4,1,2,123,-5,67,81,14,17.3,82.7
4,1,2,123,-4,129,154,25,16.2,83.8
4,1,2,123,-3,224,286,62,21.7,78.3
4,1,2,123,-2,298,450,152,33.8,66.2
4,1,2,123,-1,358,669,311,46.5,53.5
4,1,2,123,0,428,1055,627,59.4,40.6
4,1,2,123,1,274,985,711,72.2,27.8
4,1,2,123,2,109,716,607,84.8,15.2
4,1,2,123,3,60,505,445,88.1,11.9
4,1,2,123,4,23,381,358,94,6
4,1,2,123,5,10,249,239,96,4
4,1,2,123,6,4,148,144,97.3,2.7
4,1,2,123,7,0,91,91,100,0
4,1,2,123,8,0,55,55,100,0
4,1,2,123,9,0,34,34,100,0
4,1,2,123,10,0,14,14,100,0
4,1,2,123,11,0,6,6,100,0
4,1,2,123,12,0,6,6,100,0
4,1,2,123,13,0,2,2,100,0
4,1,2,123,15,0,2,2,100,0
5,0,0,0,-18,1,1,0,0,100
5,0,0,0,-17,2,2,0,0,100
5,0,0,0,-16,3,3,0,0,100
5,0,0,0,-15,2,2,0,0,100
5,0,0,0,-14,12,12,0,0,100
5,0,0,0,-13,19,19,0,0,100
5,0,0,0,-12,49,49,0,0,100
5,0,0,0,-11,81,81,0,0,100
5,0,0,0,-10,172,173,1,0.6,99.4
5,0,0,0,-9,326,329,3,0.9,99.1
5,0,0,0,-8,582,594,12,2,98
5,0,0,0,-7,1003,1027,24,2.3,97.7
5,0,0,0,-6,1704,1769,65,3.7,96.3
5,0,0,0,-5,2816,2991,175,5.9,94.1
5,0,0,0,-4,4560,5014,454,9.1,90.9
5,0,0,0,-3,6921,8246,1325,16.1,83.9
5,0,0,0,-2,9717,12855,3138,24.4,75.6
5,0,0,0,-1,11670,18236,6566,36,64
5,0,0,0,0,12136,24914,12778,51.3,48.7
5,0,0,0,1,6456,19370,12914,66.7,33.3
5,0,0,0,2,3044,14051,11007,78.3,21.7
5,0,0,0,3,1326,9583,8257,86.2,13.8
5,0,0,0,4,507,5965,5458,91.5,8.5
5,0,0,0,5,180,3609,3429,95,5
5,0,0,0,6,73,2211,2138,96.7,3.3
5,0,0,0,7,24,1333,1309,98.2,1.8
5,0,0,0,8,10,779,769,98.7,1.3
5,0,0,0,9,3,446,443,99.3,0.700000000000003
5,0,0,0,10,1,238,237,99.6,0.400000000000006
5,0,0,0,11,2,139,137,98.6,1.40000000000001
5,0,0,0,12,0,67,67,100,0
5,0,0,0,13,0,37,37,100,0
5,0,0,0,14,0,14,14,100,0
5,0,0,0,15,0,9,9,100,0
5,0,0,0,16,0,2,2,100,0
5,0,0,0,17,0,4,4,100,0
5,0,0,0,18,0,3,3,100,0
5,0,0,1,-17,1,1,0,0,100
5,0,0,1,-15,2,2,0,0,100
5,0,0,1,-14,2,2,0,0,100
5,0,0,1,-13,8,8,0,0,100
5,0,0,1,-12,17,17,0,0,100
5,0,0,1,-11,26,26,0,0,100
5,0,0,1,-10,46,46,0,0,100
5,0,0,1,-9,84,85,1,1.2,98.8
5,0,0,1,-8,156,156,0,0,100
5,0,0,1,-7,243,247,4,1.6,98.4
5,0,0,1,-6,493,507,14,2.8,97.2
5,0,0,1,-5,798,830,32,3.9,96.1
5,0,0,1,-4,1243,1364,121,8.9,91.1
5,0,0,1,-3,1946,2268,322,14.2,85.8
5,0,0,1,-2,2588,3296,708,21.5,78.5
5,0,0,1,-1,2993,4380,1387,31.7,68.3
5,0,0,1,0,3284,6104,2820,46.2,53.8
5,0,0,1,1,1858,4791,2933,61.2,38.8
5,0,0,1,2,881,3380,2499,73.9,26.1
5,0,0,1,3,407,2374,1967,82.9,17.1
5,0,0,1,4,168,1441,1273,88.3,11.7
5,0,0,1,5,53,912,859,94.2,5.80000000000001
5,0,0,1,6,25,557,532,95.5,4.5
5,0,0,1,7,10,326,316,96.9,3.10000000000001
5,0,0,1,8,5,192,187,97.4,2.60000000000001
5,0,0,1,9,1,103,102,99,1
5,0,0,1,10,0,63,63,100,0
5,0,0,1,11,1,36,35,97.2,2.8
5,0,0,1,12,0,9,9,100,0
5,0,0,1,13,0,9,9,100,0
5,0,0,1,14,0,2,2,100,0
5,0,0,1,15,0,2,2,100,0
5,0,0,1,17,0,1,1,100,0
5,0,0,2,-16,1,1,0,0,100
5,0,0,2,-15,1,1,0,0,100
5,0,0,2,-13,1,1,0,0,100
5,0,0,2,-12,1,1,0,0,100
5,0,0,2,-11,11,11,0,0,100
5,0,0,2,-10,11,11,0,0,100
5,0,0,2,-9,30,30,0,0,100
5,0,0,2,-8,39,40,1,2.5,97.5
5,0,0,2,-7,77,77,0,0,100
5,0,0,2,-6,172,181,9,5,95
5,0,0,2,-5,250,264,14,5.3,94.7
5,0,0,2,-4,427,468,41,8.8,91.2
5,0,0,2,-3,653,730,77,10.5,89.5
5,0,0,2,-2,829,1012,183,18.1,81.9
5,0,0,2,-1,935,1312,377,28.7,71.3
5,0,0,2,0,965,1676,711,42.4,57.6
5,0,0,2,1,555,1304,749,57.4,42.6
5,0,0,2,2,258,832,574,69,31
5,0,0,2,3,124,577,453,78.5,21.5
5,0,0,2,4,54,356,302,84.8,15.2
5,0,0,2,5,21,205,184,89.8,10.2
5,0,0,2,6,3,118,115,97.5,2.5
5,0,0,2,7,1,73,72,98.6,1.40000000000001
5,0,0,2,8,1,43,42,97.7,2.3
5,0,0,2,9,0,34,34,100,0
5,0,0,2,10,0,15,15,100,0
5,0,0,2,11,0,11,11,100,0
5,0,0,2,12,0,2,2,100,0
5,0,0,2,15,0,1,1,100,0
5,0,0,2,16,0,1,1,100,0
5,0,0,2,18,0,1,1,100,0
5,0,0,12,-15,1,1,0,0,100
5,0,0,12,-14,1,1,0,0,100
5,0,0,12,-13,3,3,0,0,100
5,0,0,12,-12,7,7,0,0,100
5,0,0,12,-11,10,10,0,0,100
5,0,0,12,-10,19,19,0,0,100
5,0,0,12,-9,34,34,0,0,100
5,0,0,12,-8,49,49,0,0,100
5,0,0,12,-7,79,80,1,1.2,98.8
5,0,0,12,-6,151,154,3,1.9,98.1
5,0,0,12,-5,204,211,7,3.3,96.7
5,0,0,12,-4,341,363,22,6.1,93.9
5,0,0,12,-3,471,529,58,11,89
5,0,0,12,-2,593,723,130,18,82
5,0,0,12,-1,669,909,240,26.4,73.6
5,0,0,12,0,682,1175,493,42,58
5,0,0,12,1,441,964,523,54.3,45.7
5,0,0,12,2,263,794,531,66.9,33.1
5,0,0,12,3,137,600,463,77.2,22.8
5,0,0,12,4,59,374,315,84.2,15.8
5,0,0,12,5,15,217,202,93.1,6.89999999999999
5,0,0,12,6,9,146,137,93.8,6.2
5,0,0,12,7,5,80,75,93.8,6.2
5,0,0,12,8,2,50,48,96,4
5,0,0,12,9,0,28,28,100,0
5,0,0,12,10,0,16,16,100,0
5,0,0,12,11,1,11,10,90.9,9.09999999999999
5,0,0,12,12,0,4,4,100,0
5,0,0,12,14,0,2,2,100,0
5,0,0,3,-14,1,1,0,0,100
5,0,0,3,-12,4,4,0,0,100
5,0,0,3,-11,1,1,0,0,100
5,0,0,3,-10,5,5,0,0,100
5,0,0,3,-9,4,4,0,0,100
5,0,0,3,-8,11,11,0,0,100
5,0,0,3,-7,24,24,0,0,100
5,0,0,3,-6,32,35,3,8.6,91.4
5,0,0,3,-5,57,57,0,0,100
5,0,0,3,-4,110,116,6,5.2,94.8
5,0,0,3,-3,130,154,24,15.6,84.4
5,0,0,3,-2,178,212,34,16,84
5,0,0,3,-1,187,245,58,23.7,76.3
5,0,0,3,0,183,300,117,39,61
5,0,0,3,1,94,182,88,48.4,51.6
5,0,0,3,2,46,134,88,65.7,34.3
5,0,0,3,3,17,89,72,80.9,19.1
5,0,0,3,4,10,49,39,79.6,20.4
5,0,0,3,5,5,40,35,87.5,12.5
5,0,0,3,6,0,21,21,100,0
5,0,0,3,7,1,10,9,90,10
5,0,0,3,8,0,5,5,100,0
5,0,0,3,9,0,4,4,100,0
5,0,0,3,10,0,1,1,100,0
5,0,0,3,11,0,1,1,100,0
5,0,0,3,13,0,1,1,100,0
5,0,0,13,-14,1,1,0,0,100
5,0,0,13,-13,2,2,0,0,100
5,0,0,13,-12,4,4,0,0,100
5,0,0,13,-11,4,4,0,0,100
5,0,0,13,-10,6,6,0,0,100
5,0,0,13,-9,7,7,0,0,100
5,0,0,13,-8,23,23,0,0,100
5,0,0,13,-7,33,33,0,0,100
5,0,0,13,-6,66,68,2,2.9,97.1
5,0,0,13,-5,87,90,3,3.3,96.7
5,0,0,13,-4,176,188,12,6.4,93.6
5,0,0,13,-3,268,290,22,7.6,92.4
5,0,0,13,-2,287,332,45,13.6,86.4
5,0,0,13,-1,335,444,109,24.5,75.5
5,0,0,13,0,371,565,194,34.3,65.7
5,0,0,13,1,212,399,187,46.9,53.1
5,0,0,13,2,105,262,157,59.9,40.1
5,0,0,13,3,40,173,133,76.9,23.1
5,0,0,13,4,19,124,105,84.7,15.3
5,0,0,13,5,11,63,52,82.5,17.5
5,0,0,13,6,2,42,40,95.2,4.80000000000001
5,0,0,13,7,1,16,15,93.8,6.2
5,0,0,13,8,1,14,13,92.9,7.09999999999999
5,0,0,13,9,0,7,7,100,0
5,0,0,13,10,0,3,3,100,0
5,0,0,13,11,0,2,2,100,0
5,0,0,13,12,0,1,1,100,0
5,0,0,13,13,0,1,1,100,0
5,0,0,13,15,0,1,1,100,0
5,0,0,23,-11,2,2,0,0,100
5,0,0,23,-10,3,3,0,0,100
5,0,0,23,-9,8,8,0,0,100
5,0,0,23,-8,17,17,0,0,100
5,0,0,23,-7,19,19,0,0,100
5,0,0,23,-6,49,49,0,0,100
5,0,0,23,-5,65,69,4,5.8,94.2
5,0,0,23,-4,93,99,6,6.1,93.9
5,0,0,23,-3,133,140,7,5,95
5,0,0,23,-2,188,216,28,13,87
5,0,0,23,-1,185,234,49,20.9,79.1
5,0,0,23,0,206,286,80,28,72
5,0,0,23,1,144,250,106,42.4,57.6
5,0,0,23,2,60,170,110,64.7,35.3
5,0,0,23,3,30,103,73,70.9,29.1
5,0,0,23,4,8,57,49,86,14
5,0,0,23,5,7,48,41,85.4,14.6
5,0,0,23,6,1,17,16,94.1,5.90000000000001
5,0,0,23,7,0,16,16,100,0
5,0,0,23,8,0,8,8,100,0
5,0,0,23,9,0,5,5,100,0
5,0,0,23,10,0,5,5,100,0
5,0,0,23,11,0,4,4,100,0
5,0,0,23,13,0,1,1,100,0
5,0,0,123,-13,2,2,0,0,100
5,0,0,123,-12,3,3,0,0,100
5,0,0,123,-11,2,2,0,0,100
5,0,0,123,-10,8,8,0,0,100
5,0,0,123,-9,15,15,0,0,100
5,0,0,123,-8,10,10,0,0,100
5,0,0,123,-7,23,24,1,4.2,95.8
5,0,0,123,-6,38,39,1,2.6,97.4
5,0,0,123,-5,61,64,3,4.7,95.3
5,0,0,123,-4,101,107,6,5.6,94.4
5,0,0,123,-3,121,130,9,6.9,93.1
5,0,0,123,-2,157,185,28,15.1,84.9
5,0,0,123,-1,168,200,32,16,84
5,0,0,123,0,189,277,88,31.8,68.2
5,0,0,123,1,129,208,79,38,62
5,0,0,123,2,75,162,87,53.7,46.3
5,0,0,123,3,35,117,82,70.1,29.9
5,0,0,123,4,16,74,58,78.4,21.6
5,0,0,123,5,9,45,36,80,20
5,0,0,123,6,4,28,24,85.7,14.3
5,0,0,123,7,3,17,14,82.4,17.6
5,0,0,123,8,0,12,12,100,0
5,0,0,123,9,0,4,4,100,0
5,0,0,123,10,0,2,2,100,0
5,0,0,123,11,0,2,2,100,0
5,0,1,0,-18,1,1,0,0,100
5,0,1,0,-17,2,2,0,0,100
5,0,1,0,-16,4,4,0,0,100
5,0,1,0,-15,2,2,0,0,100
5,0,1,0,-14,12,12,0,0,100
5,0,1,0,-13,22,22,0,0,100
5,0,1,0,-12,39,39,0,0,100
5,0,1,0,-11,69,69,0,0,100
5,0,1,0,-10,139,140,1,0.7,99.3
5,0,1,0,-9,249,251,2,0.8,99.2
5,0,1,0,-8,490,502,12,2.4,97.6
5,0,1,0,-7,814,836,22,2.6,97.4
5,0,1,0,-6,1312,1364,52,3.8,96.2
5,0,1,0,-5,2171,2329,158,6.8,93.2
5,0,1,0,-4,3491,3855,364,9.4,90.6
5,0,1,0,-3,4971,6030,1059,17.6,82.4
5,0,1,0,-2,7023,9492,2469,26,74
5,0,1,0,-1,8256,13441,5185,38.6,61.4
5,0,1,0,0,8099,17722,9623,54.3,45.7
5,0,1,0,1,4128,13720,9592,69.9,30.1
5,0,1,0,2,1897,10005,8108,81,19
5,0,1,0,3,786,6676,5890,88.2,11.8
5,0,1,0,4,275,4184,3909,93.4,6.59999999999999
5,0,1,0,5,100,2480,2380,96,4
5,0,1,0,6,42,1538,1496,97.3,2.7
5,0,1,0,7,12,930,918,98.7,1.3
5,0,1,0,8,5,538,533,99.1,0.900000000000006
5,0,1,0,9,2,310,308,99.4,0.599999999999994
5,0,1,0,10,1,155,154,99.4,0.599999999999994
5,0,1,0,11,0,89,89,100,0
5,0,1,0,12,0,54,54,100,0
5,0,1,0,13,0,27,27,100,0
5,0,1,0,14,0,11,11,100,0
5,0,1,0,15,0,7,7,100,0
5,0,1,0,17,0,3,3,100,0
5,0,1,0,18,0,2,2,100,0
5,0,1,1,-17,2,2,0,0,100
5,0,1,1,-16,1,1,0,0,100
5,0,1,1,-15,3,3,0,0,100
5,0,1,1,-14,5,5,0,0,100
5,0,1,1,-13,12,12,0,0,100
5,0,1,1,-12,22,22,0,0,100
5,0,1,1,-11,38,38,0,0,100
5,0,1,1,-10,65,66,1,1.5,98.5
5,0,1,1,-9,126,127,1,0.8,99.2
5,0,1,1,-8,229,233,4,1.7,98.3
5,0,1,1,-7,346,353,7,2,98
5,0,1,1,-6,619,636,17,2.7,97.3
5,0,1,1,-5,1040,1095,55,5,95
5,0,1,1,-4,1652,1833,181,9.9,90.1
5,0,1,1,-3,2212,2681,469,17.5,82.5
5,0,1,1,-2,3035,3939,904,22.9,77.1
5,0,1,1,-1,3353,5212,1859,35.7,64.3
5,0,1,1,0,3409,6802,3393,49.9,50.1
5,0,1,1,1,1797,5289,3492,66,34
5,0,1,1,2,888,3952,3064,77.5,22.5
5,0,1,1,3,344,2659,2315,87.1,12.9
5,0,1,1,4,138,1687,1549,91.8,8.2
5,0,1,1,5,48,1054,1006,95.4,4.60000000000001
5,0,1,1,6,23,678,655,96.6,3.40000000000001
5,0,1,1,7,7,377,370,98.1,1.90000000000001
5,0,1,1,8,2,205,203,99,1
5,0,1,1,9,2,140,138,98.6,1.40000000000001
5,0,1,1,10,1,58,57,98.3,1.7
5,0,1,1,11,0,44,44,100,0
5,0,1,1,12,0,20,20,100,0
5,0,1,1,13,0,10,10,100,0
5,0,1,1,14,0,2,2,100,0
5,0,1,1,15,0,2,2,100,0
5,0,1,1,17,0,1,1,100,0
5,0,1,2,-15,1,1,0,0,100
5,0,1,2,-14,3,3,0,0,100
5,0,1,2,-13,7,7,0,0,100
5,0,1,2,-12,9,9,0,0,100
5,0,1,2,-11,14,14,0,0,100
5,0,1,2,-10,23,23,0,0,100
5,0,1,2,-9,54,54,0,0,100
5,0,1,2,-8,93,95,2,2.1,97.9
5,0,1,2,-7,170,172,2,1.2,98.8
5,0,1,2,-6,287,298,11,3.7,96.3
5,0,1,2,-5,523,549,26,4.7,95.3
5,0,1,2,-4,798,884,86,9.7,90.3
5,0,1,2,-3,1215,1430,215,15,85
5,0,1,2,-2,1630,2111,481,22.8,77.2
5,0,1,2,-1,1765,2626,861,32.8,67.2
5,0,1,2,0,1684,3192,1508,47.2,52.8
5,0,1,2,1,804,2214,1410,63.7,36.3
5,0,1,2,2,337,1386,1049,75.7,24.3
5,0,1,2,3,139,871,732,84,16
5,0,1,2,4,50,532,482,90.6,9.39999999999999
5,0,1,2,5,15,313,298,95.2,4.80000000000001
5,0,1,2,6,5,200,195,97.5,2.5
5,0,1,2,7,3,104,101,97.1,2.90000000000001
5,0,1,2,8,1,74,73,98.6,1.40000000000001
5,0,1,2,9,1,39,38,97.4,2.60000000000001
5,0,1,2,10,0,23,23,100,0
5,0,1,2,11,0,12,12,100,0
5,0,1,2,12,0,5,5,100,0
5,0,1,2,13,0,2,2,100,0
5,0,1,2,15,0,1,1,100,0
5,0,1,2,17,0,1,1,100,0
5,0,1,2,18,0,2,2,100,0
5,0,1,12,-17,1,1,0,0,100
5,0,1,12,-15,1,1,0,0,100
5,0,1,12,-14,1,1,0,0,100
5,0,1,12,-13,3,3,0,0,100
5,0,1,12,-12,11,11,0,0,100
5,0,1,12,-11,10,10,0,0,100
5,0,1,12,-10,39,40,1,2.5,97.5
5,0,1,12,-9,64,64,0,0,100
5,0,1,12,-8,90,93,3,3.2,96.8
5,0,1,12,-7,153,155,2,1.3,98.7
5,0,1,12,-6,283,297,14,4.7,95.3
5,0,1,12,-5,473,495,22,4.4,95.6
5,0,1,12,-4,663,742,79,10.6,89.4
5,0,1,12,-3,897,1056,159,15.1,84.9
5,0,1,12,-2,1180,1511,331,21.9,78.1
5,0,1,12,-1,1267,1836,569,31,69
5,0,1,12,0,1077,2046,969,47.4,52.6
5,0,1,12,1,612,1597,985,61.7,38.3
5,0,1,12,2,339,1214,875,72.1,27.9
5,0,1,12,3,164,882,718,81.4,18.6
5,0,1,12,4,70,605,535,88.4,11.6
5,0,1,12,5,17,365,348,95.3,4.7
5,0,1,12,6,11,235,224,95.3,4.7
5,0,1,12,7,7,144,137,95.1,4.90000000000001
5,0,1,12,8,4,77,73,94.8,5.2
5,0,1,12,9,1,42,41,97.6,2.40000000000001
5,0,1,12,10,1,24,23,95.8,4.2
5,0,1,12,11,0,14,14,100,0
5,0,1,12,12,0,11,11,100,0
5,0,1,12,13,0,4,4,100,0
5,0,1,12,14,0,1,1,100,0
5,0,1,12,17,0,1,1,100,0
5,0,1,3,-16,1,1,0,0,100
5,0,1,3,-12,2,2,0,0,100
5,0,1,3,-11,5,5,0,0,100
5,0,1,3,-10,11,11,0,0,100
5,0,1,3,-9,18,18,0,0,100
5,0,1,3,-8,41,41,0,0,100
5,0,1,3,-7,70,70,0,0,100
5,0,1,3,-6,108,113,5,4.4,95.6
5,0,1,3,-5,182,196,14,7.1,92.9
5,0,1,3,-4,322,346,24,6.9,93.1
5,0,1,3,-3,454,536,82,15.3,84.7
5,0,1,3,-2,565,719,154,21.4,78.6
5,0,1,3,-1,638,911,273,30,70
5,0,1,3,0,576,1038,462,44.5,55.5
5,0,1,3,1,286,706,420,59.5,40.5
5,0,1,3,2,118,430,312,72.6,27.4
5,0,1,3,3,54,281,227,80.8,19.2
5,0,1,3,4,23,147,124,84.4,15.6
5,0,1,3,5,8,93,85,91.4,8.59999999999999
5,0,1,3,6,2,60,58,96.7,3.3
5,0,1,3,7,1,35,34,97.1,2.90000000000001
5,0,1,3,8,0,16,16,100,0
5,0,1,3,9,0,13,13,100,0
5,0,1,3,10,0,10,10,100,0
5,0,1,3,11,0,3,3,100,0
5,0,1,3,12,0,1,1,100,0
5,0,1,3,13,0,1,1,100,0
5,0,1,3,16,0,1,1,100,0
5,0,1,13,-13,3,3,0,0,100
5,0,1,13,-12,5,5,0,0,100
5,0,1,13,-11,10,11,1,9.1,90.9
5,0,1,13,-10,11,11,0,0,100
5,0,1,13,-9,23,24,1,4.2,95.8
5,0,1,13,-8,53,53,0,0,100
5,0,1,13,-7,82,82,0,0,100
5,0,1,13,-6,162,162,0,0,100
5,0,1,13,-5,235,245,10,4.1,95.9
5,0,1,13,-4,370,401,31,7.7,92.3
5,0,1,13,-3,522,594,72,12.1,87.9
5,0,1,13,-2,606,744,138,18.5,81.5
5,0,1,13,-1,666,920,254,27.6,72.4
5,0,1,13,0,661,1100,439,39.9,60.1
5,0,1,13,1,335,739,404,54.7,45.3
5,0,1,13,2,163,519,356,68.6,31.4
5,0,1,13,3,66,368,302,82.1,17.9
5,0,1,13,4,24,222,198,89.2,10.8
5,0,1,13,5,9,125,116,92.8,7.19999999999999
5,0,1,13,6,4,82,78,95.1,4.90000000000001
5,0,1,13,7,3,40,37,92.5,7.5
5,0,1,13,8,2,24,22,91.7,8.3
5,0,1,13,9,0,21,21,100,0
5,0,1,13,10,0,5,5,100,0
5,0,1,13,11,0,3,3,100,0
5,0,1,13,12,0,2,2,100,0
5,0,1,23,-15,1,1,0,0,100
5,0,1,23,-14,2,2,0,0,100
5,0,1,23,-13,1,1,0,0,100
5,0,1,23,-12,4,4,0,0,100
5,0,1,23,-11,10,10,0,0,100
5,0,1,23,-10,11,11,0,0,100
5,0,1,23,-9,20,20,0,0,100
5,0,1,23,-8,37,37,0,0,100
5,0,1,23,-7,55,55,0,0,100
5,0,1,23,-6,117,120,3,2.5,97.5
5,0,1,23,-5,195,203,8,3.9,96.1
5,0,1,23,-4,289,311,22,7.1,92.9
5,0,1,23,-3,409,444,35,7.9,92.1
5,0,1,23,-2,472,565,93,16.5,83.5
5,0,1,23,-1,497,673,176,26.2,73.8
5,0,1,23,0,495,765,270,35.3,64.7
5,0,1,23,1,256,587,331,56.4,43.6
5,0,1,23,2,129,446,317,71.1,28.9
5,0,1,23,3,59,233,174,74.7,25.3
5,0,1,23,4,17,121,104,86,14
5,0,1,23,5,13,91,78,85.7,14.3
5,0,1,23,6,1,58,57,98.3,1.7
5,0,1,23,7,0,35,35,100,0
5,0,1,23,8,0,16,16,100,0
5,0,1,23,9,0,12,12,100,0
5,0,1,23,10,0,3,3,100,0
5,0,1,23,11,0,2,2,100,0
5,0,1,23,12,0,3,3,100,0
5,0,1,23,13,0,3,3,100,0
5,0,1,123,-13,4,4,0,0,100
5,0,1,123,-12,6,6,0,0,100
5,0,1,123,-11,6,6,0,0,100
5,0,1,123,-10,15,15,0,0,100
5,0,1,123,-9,22,22,0,0,100
5,0,1,123,-8,27,27,0,0,100
5,0,1,123,-7,73,74,1,1.4,98.6
5,0,1,123,-6,127,133,6,4.5,95.5
5,0,1,123,-5,183,194,11,5.7,94.3
5,0,1,123,-4,271,291,20,6.9,93.1
5,0,1,123,-3,426,463,37,8,92
5,0,1,123,-2,524,631,107,17,83
5,0,1,123,-1,477,630,153,24.3,75.7
5,0,1,123,0,400,658,258,39.2,60.8
5,0,1,123,1,213,435,222,51,49
5,0,1,123,2,111,312,201,64.4,35.6
5,0,1,123,3,57,221,164,74.2,25.8
5,0,1,123,4,25,140,115,82.1,17.9
5,0,1,123,5,6,97,91,93.8,6.2
5,0,1,123,6,4,46,42,91.3,8.7
5,0,1,123,7,2,34,32,94.1,5.90000000000001
5,0,1,123,8,1,26,25,96.2,3.8
5,0,1,123,9,0,8,8,100,0
5,0,1,123,10,1,2,1,50,50
5,0,1,123,11,0,5,5,100,0
5,0,1,123,12,0,5,5,100,0
5,0,1,123,13,0,1,1,100,0
5,0,2,0,-19,1,1,0,0,100
5,0,2,0,-18,2,2,0,0,100
5,0,2,0,-17,3,3,0,0,100
5,0,2,0,-16,2,2,0,0,100
5,0,2,0,-15,2,2,0,0,100
5,0,2,0,-14,16,16,0,0,100
5,0,2,0,-13,35,35,0,0,100
5,0,2,0,-12,49,49,0,0,100
5,0,2,0,-11,71,71,0,0,100
5,0,2,0,-10,150,150,0,0,100
5,0,2,0,-9,226,229,3,1.3,98.7
5,0,2,0,-8,444,451,7,1.6,98.4
5,0,2,0,-7,747,770,23,3,97
5,0,2,0,-6,1213,1267,54,4.3,95.7
5,0,2,0,-5,1981,2137,156,7.3,92.7
5,0,2,0,-4,2951,3304,353,10.7,89.3
5,0,2,0,-3,4132,5057,925,18.3,81.7
5,0,2,0,-2,5670,7806,2136,27.4,72.6
5,0,2,0,-1,6460,10845,4385,40.4,59.6
5,0,2,0,0,6029,13853,7824,56.5,43.5
5,0,2,0,1,3019,10795,7776,72,28
5,0,2,0,2,1311,7796,6485,83.2,16.8
5,0,2,0,3,578,5211,4633,88.9,11.1
5,0,2,0,4,209,3218,3009,93.5,6.5
5,0,2,0,5,69,1899,1830,96.4,3.60000000000001
5,0,2,0,6,25,1129,1104,97.8,2.2
5,0,2,0,7,8,715,707,98.9,1.09999999999999
5,0,2,0,8,3,428,425,99.3,0.700000000000003
5,0,2,0,9,1,227,226,99.6,0.400000000000006
5,0,2,0,10,0,128,128,100,0
5,0,2,0,11,0,64,64,100,0
5,0,2,0,12,0,34,34,100,0
5,0,2,0,13,0,20,20,100,0
5,0,2,0,14,0,10,10,100,0
5,0,2,0,15,0,6,6,100,0
5,0,2,0,16,0,1,1,100,0
5,0,2,0,17,0,2,2,100,0
5,0,2,0,18,0,1,1,100,0
5,0,2,1,-19,1,1,0,0,100
5,0,2,1,-18,1,1,0,0,100
5,0,2,1,-17,3,3,0,0,100
5,0,2,1,-16,5,5,0,0,100
5,0,2,1,-15,1,1,0,0,100
5,0,2,1,-14,11,11,0,0,100
5,0,2,1,-13,15,15,0,0,100
5,0,2,1,-12,31,31,0,0,100
5,0,2,1,-11,56,56,0,0,100
5,0,2,1,-10,101,102,1,1,99
5,0,2,1,-9,168,170,2,1.2,98.8
5,0,2,1,-8,291,295,4,1.4,98.6
5,0,2,1,-7,475,485,10,2.1,97.9
5,0,2,1,-6,732,761,29,3.8,96.2
5,0,2,1,-5,1166,1244,78,6.3,93.7
5,0,2,1,-4,1776,1965,189,9.6,90.4
5,0,2,1,-3,2335,2859,524,18.3,81.7
5,0,2,1,-2,3033,4144,1111,26.8,73.2
5,0,2,1,-1,3351,5405,2054,38,62
5,0,2,1,0,3037,6528,3491,53.5,46.5
5,0,2,1,1,1527,5139,3612,70.3,29.7
5,0,2,1,2,715,3865,3150,81.5,18.5
5,0,2,1,3,312,2571,2259,87.9,12.1
5,0,2,1,4,106,1663,1557,93.6,6.39999999999999
5,0,2,1,5,41,996,955,95.9,4.10000000000001
5,0,2,1,6,14,620,606,97.7,2.3
5,0,2,1,7,2,369,367,99.5,0.5
5,0,2,1,8,1,220,219,99.5,0.5
5,0,2,1,9,1,126,125,99.2,0.799999999999997
5,0,2,1,10,0,51,51,100,0
5,0,2,1,11,0,41,41,100,0
5,0,2,1,12,0,22,22,100,0
5,0,2,1,13,0,3,3,100,0
5,0,2,1,14,0,5,5,100,0
5,0,2,1,15,0,3,3,100,0
5,0,2,1,17,0,1,1,100,0
5,0,2,2,-17,1,1,0,0,100
5,0,2,2,-16,1,1,0,0,100
5,0,2,2,-15,8,8,0,0,100
5,0,2,2,-14,2,2,0,0,100
5,0,2,2,-13,12,12,0,0,100
5,0,2,2,-12,23,24,1,4.2,95.8
5,0,2,2,-11,30,30,0,0,100
5,0,2,2,-10,47,47,0,0,100
5,0,2,2,-9,95,95,0,0,100
5,0,2,2,-8,166,173,7,4,96
5,0,2,2,-7,287,293,6,2,98
5,0,2,2,-6,448,464,16,3.4,96.6
5,0,2,2,-5,777,831,54,6.5,93.5
5,0,2,2,-4,1089,1223,134,11,89
5,0,2,2,-3,1519,1832,313,17.1,82.9
5,0,2,2,-2,1939,2619,680,26,74
5,0,2,2,-1,2083,3316,1233,37.2,62.8
5,0,2,2,0,1852,3916,2064,52.7,47.3
5,0,2,2,1,938,2844,1906,67,33
5,0,2,2,2,369,1802,1433,79.5,20.5
5,0,2,2,3,149,1130,981,86.8,13.2
5,0,2,2,4,56,689,633,91.9,8.09999999999999
5,0,2,2,5,12,392,380,96.9,3.10000000000001
5,0,2,2,6,10,258,248,96.1,3.90000000000001
5,0,2,2,7,7,135,128,94.8,5.2
5,0,2,2,8,1,93,92,98.9,1.09999999999999
5,0,2,2,9,0,39,39,100,0
5,0,2,2,10,0,27,27,100,0
5,0,2,2,11,0,14,14,100,0
5,0,2,2,12,0,3,3,100,0
5,0,2,2,13,0,3,3,100,0
5,0,2,2,14,0,1,1,100,0
5,0,2,2,15,0,1,1,100,0
5,0,2,2,16,0,1,1,100,0
5,0,2,2,17,0,1,1,100,0
5,0,2,2,18,0,2,2,100,0
5,0,2,12,-18,1,1,0,0,100
5,0,2,12,-17,3,3,0,0,100
5,0,2,12,-16,2,2,0,0,100
5,0,2,12,-15,2,2,0,0,100
5,0,2,12,-14,2,2,0,0,100
5,0,2,12,-13,14,14,0,0,100
5,0,2,12,-12,29,29,0,0,100
5,0,2,12,-11,29,29,0,0,100
5,0,2,12,-10,68,68,0,0,100
5,0,2,12,-9,102,102,0,0,100
5,0,2,12,-8,167,169,2,1.2,98.8
5,0,2,12,-7,234,241,7,2.9,97.1
5,0,2,12,-6,415,436,21,4.8,95.2
5,0,2,12,-5,680,716,36,5,95
5,0,2,12,-4,973,1096,123,11.2,88.8
5,0,2,12,-3,1258,1509,251,16.6,83.4
5,0,2,12,-2,1498,2008,510,25.4,74.6
5,0,2,12,-1,1555,2404,849,35.3,64.7
5,0,2,12,0,1346,2757,1411,51.2,48.8
5,0,2,12,1,693,2074,1381,66.6,33.4
5,0,2,12,2,312,1434,1122,78.2,21.8
5,0,2,12,3,133,1023,890,87,13
5,0,2,12,4,66,691,625,90.4,9.59999999999999
5,0,2,12,5,16,400,384,96,4
5,0,2,12,6,14,252,238,94.4,5.60000000000001
5,0,2,12,7,3,143,140,97.9,2.10000000000001
5,0,2,12,8,1,64,63,98.4,1.59999999999999
5,0,2,12,9,0,46,46,100,0
5,0,2,12,10,0,18,18,100,0
5,0,2,12,11,0,15,15,100,0
5,0,2,12,12,0,4,4,100,0
5,0,2,12,13,0,1,1,100,0
5,0,2,12,17,0,2,2,100,0
5,0,2,3,-16,2,2,0,0,100
5,0,2,3,-15,1,1,0,0,100
5,0,2,3,-14,2,2,0,0,100
5,0,2,3,-13,6,6,0,0,100
5,0,2,3,-12,3,3,0,0,100
5,0,2,3,-11,16,16,0,0,100
5,0,2,3,-10,24,24,0,0,100
5,0,2,3,-9,23,23,0,0,100
5,0,2,3,-8,69,69,0,0,100
5,0,2,3,-7,111,112,1,0.9,99.1
5,0,2,3,-6,180,187,7,3.7,96.3
5,0,2,3,-5,305,332,27,8.1,91.9
5,0,2,3,-4,438,482,44,9.1,90.9
5,0,2,3,-3,642,776,134,17.3,82.7
5,0,2,3,-2,837,1104,267,24.2,75.8
5,0,2,3,-1,813,1289,476,36.9,63.1
5,0,2,3,0,703,1469,766,52.1,47.9
5,0,2,3,1,358,1113,755,67.8,32.2
5,0,2,3,2,133,680,547,80.4,19.6
5,0,2,3,3,53,398,345,86.7,13.3
5,0,2,3,4,26,226,200,88.5,11.5
5,0,2,3,5,4,140,136,97.1,2.90000000000001
5,0,2,3,6,5,90,85,94.4,5.60000000000001
5,0,2,3,7,0,52,52,100,0
5,0,2,3,8,0,30,30,100,0
5,0,2,3,9,1,17,16,94.1,5.90000000000001
5,0,2,3,10,0,10,10,100,0
5,0,2,3,11,1,5,4,80,20
5,0,2,3,12,0,2,2,100,0
5,0,2,3,13,0,2,2,100,0
5,0,2,3,14,0,1,1,100,0
5,0,2,3,15,0,1,1,100,0
5,0,2,13,-18,1,1,0,0,100
5,0,2,13,-15,2,2,0,0,100
5,0,2,13,-14,3,3,0,0,100
5,0,2,13,-12,4,4,0,0,100
5,0,2,13,-11,22,22,0,0,100
5,0,2,13,-10,29,30,1,3.3,96.7
5,0,2,13,-9,49,49,0,0,100
5,0,2,13,-8,80,80,0,0,100
5,0,2,13,-7,157,161,4,2.5,97.5
5,0,2,13,-6,208,216,8,3.7,96.3
5,0,2,13,-5,308,325,17,5.2,94.8
5,0,2,13,-4,514,561,47,8.4,91.6
5,0,2,13,-3,654,777,123,15.8,84.2
5,0,2,13,-2,717,941,224,23.8,76.2
5,0,2,13,-1,747,1133,386,34.1,65.9
5,0,2,13,0,642,1311,669,51,49
5,0,2,13,1,320,924,604,65.4,34.6
5,0,2,13,2,159,634,475,74.9,25.1
5,0,2,13,3,68,415,347,83.6,16.4
5,0,2,13,4,21,271,250,92.3,7.69999999999999
5,0,2,13,5,10,165,155,93.9,6.10000000000001
5,0,2,13,6,4,100,96,96,4
5,0,2,13,7,3,58,55,94.8,5.2
5,0,2,13,8,1,31,30,96.8,3.2
5,0,2,13,9,1,15,14,93.3,6.69999999999999
5,0,2,13,10,0,13,13,100,0
5,0,2,13,11,0,5,5,100,0
5,0,2,13,12,0,2,2,100,0
5,0,2,13,13,0,2,2,100,0
5,0,2,13,15,0,1,1,100,0
5,0,2,23,-14,3,3,0,0,100
5,0,2,23,-13,4,4,0,0,100
5,0,2,23,-12,4,4,0,0,100
5,0,2,23,-11,5,5,0,0,100
5,0,2,23,-10,12,12,0,0,100
5,0,2,23,-9,36,36,0,0,100
5,0,2,23,-8,54,55,1,1.8,98.2
5,0,2,23,-7,72,72,0,0,100
5,0,2,23,-6,136,141,5,3.5,96.5
5,0,2,23,-5,211,224,13,5.8,94.2
5,0,2,23,-4,325,359,34,9.5,90.5
5,0,2,23,-3,397,464,67,14.4,85.6
5,0,2,23,-2,481,612,131,21.4,78.6
5,0,2,23,-1,474,724,250,34.5,65.5
5,0,2,23,0,383,755,372,49.3,50.7
5,0,2,23,1,198,571,373,65.3,34.7
5,0,2,23,2,114,450,336,74.7,25.3
5,0,2,23,3,49,285,236,82.8,17.2
5,0,2,23,4,16,172,156,90.7,9.3
5,0,2,23,5,2,99,97,98,2
5,0,2,23,6,0,70,70,100,0
5,0,2,23,7,0,35,35,100,0
5,0,2,23,8,0,15,15,100,0
5,0,2,23,9,0,6,6,100,0
5,0,2,23,10,0,9,9,100,0
5,0,2,23,11,0,8,8,100,0
5,0,2,23,12,0,1,1,100,0
5,0,2,23,13,0,2,2,100,0
5,0,2,123,-15,1,1,0,0,100
5,0,2,123,-13,6,6,0,0,100
5,0,2,123,-12,6,6,0,0,100
5,0,2,123,-11,14,14,0,0,100
5,0,2,123,-10,24,24,0,0,100
5,0,2,123,-9,35,35,0,0,100
5,0,2,123,-8,49,51,2,3.9,96.1
5,0,2,123,-7,94,94,0,0,100
5,0,2,123,-6,160,167,7,4.2,95.8
5,0,2,123,-5,241,254,13,5.1,94.9
5,0,2,123,-4,385,413,28,6.8,93.2
5,0,2,123,-3,461,537,76,14.2,85.8
5,0,2,123,-2,524,682,158,23.2,76.8
5,0,2,123,-1,505,750,245,32.7,67.3
5,0,2,123,0,424,827,403,48.7,51.3
5,0,2,123,1,189,578,389,67.3,32.7
5,0,2,123,2,103,419,316,75.4,24.6
5,0,2,123,3,48,270,222,82.2,17.8
5,0,2,123,4,13,180,167,92.8,7.19999999999999
5,0,2,123,5,4,110,106,96.4,3.60000000000001
5,0,2,123,6,6,50,44,88,12
5,0,2,123,7,0,33,33,100,0
5,0,2,123,8,0,17,17,100,0
5,0,2,123,9,0,8,8,100,0
5,0,2,123,10,0,10,10,100,0
5,0,2,123,11,0,3,3,100,0
5,0,2,123,13,0,1,1,100,0
5,0,2,123,15,0,1,1,100,0
5,1,0,0,-19,1,1,0,0,100
5,1,0,0,-18,4,4,0,0,100
5,1,0,0,-17,3,3,0,0,100
5,1,0,0,-16,7,7,0,0,100
5,1,0,0,-15,13,13,0,0,100
5,1,0,0,-14,19,19,0,0,100
5,1,0,0,-13,68,68,0,0,100
5,1,0,0,-12,107,108,1,0.9,99.1
5,1,0,0,-11,161,161,0,0,100
5,1,0,0,-10,284,285,1,0.4,99.6
5,1,0,0,-9,500,504,4,0.8,99.2
5,1,0,0,-8,937,956,19,2,98
5,1,0,0,-7,1566,1612,46,2.9,97.1
5,1,0,0,-6,2519,2632,113,4.3,95.7
5,1,0,0,-5,3979,4294,315,7.3,92.7
5,1,0,0,-4,5838,6562,724,11,89
5,1,0,0,-3,7743,9561,1818,19,81
5,1,0,0,-2,10029,13957,3928,28.1,71.9
5,1,0,0,-1,10835,18431,7596,41.2,58.8
5,1,0,0,0,9546,22566,13020,57.7,42.3
5,1,0,0,1,4732,17729,12997,73.3,26.7
5,1,0,0,2,2039,12696,10657,83.9,16.1
5,1,0,0,3,840,8574,7734,90.2,9.8
5,1,0,0,4,304,5475,5171,94.4,5.60000000000001
5,1,0,0,5,109,3374,3265,96.8,3.2
5,1,0,0,6,40,2060,2020,98.1,1.90000000000001
5,1,0,0,7,12,1261,1249,99,1
5,1,0,0,8,4,721,717,99.4,0.599999999999994
5,1,0,0,9,4,404,400,99,1
5,1,0,0,10,0,233,233,100,0
5,1,0,0,11,0,122,122,100,0
5,1,0,0,12,0,54,54,100,0
5,1,0,0,13,0,31,31,100,0
5,1,0,0,14,0,16,16,100,0
5,1,0,0,15,0,10,10,100,0
5,1,0,0,16,0,2,2,100,0
5,1,0,0,17,0,2,2,100,0
5,1,0,0,18,0,3,3,100,0
5,1,0,1,-18,2,2,0,0,100
5,1,0,1,-16,1,1,0,0,100
5,1,0,1,-15,4,4,0,0,100
5,1,0,1,-14,3,3,0,0,100
5,1,0,1,-13,17,17,0,0,100
5,1,0,1,-12,29,29,0,0,100
5,1,0,1,-11,32,32,0,0,100
5,1,0,1,-10,69,70,1,1.4,98.6
5,1,0,1,-9,131,132,1,0.8,99.2
5,1,0,1,-8,249,255,6,2.4,97.6
5,1,0,1,-7,390,413,23,5.6,94.4
5,1,0,1,-6,650,694,44,6.3,93.7
5,1,0,1,-5,987,1099,112,10.2,89.8
5,1,0,1,-4,1372,1594,222,13.9,86.1
5,1,0,1,-3,1761,2318,557,24,76
5,1,0,1,-2,2344,3557,1213,34.1,65.9
5,1,0,1,-1,2420,4608,2188,47.5,52.5
5,1,0,1,0,2146,5640,3494,62,38
5,1,0,1,1,1085,4483,3398,75.8,24.2
5,1,0,1,2,452,3364,2912,86.6,13.4
5,1,0,1,3,180,2303,2123,92.2,7.8
5,1,0,1,4,68,1519,1451,95.5,4.5
5,1,0,1,5,25,928,903,97.3,2.7
5,1,0,1,6,13,594,581,97.8,2.2
5,1,0,1,7,3,372,369,99.2,0.799999999999997
5,1,0,1,8,1,192,191,99.5,0.5
5,1,0,1,9,2,103,101,98.1,1.90000000000001
5,1,0,1,10,0,63,63,100,0
5,1,0,1,11,0,32,32,100,0
5,1,0,1,12,0,11,11,100,0
5,1,0,1,13,0,5,5,100,0
5,1,0,1,14,0,3,3,100,0
5,1,0,1,15,0,3,3,100,0
5,1,0,1,16,0,1,1,100,0
5,1,0,1,18,0,2,2,100,0
5,1,0,2,-16,1,1,0,0,100
5,1,0,2,-15,1,1,0,0,100
5,1,0,2,-14,4,4,0,0,100
5,1,0,2,-13,1,1,0,0,100
5,1,0,2,-12,6,6,0,0,100
5,1,0,2,-11,11,11,0,0,100
5,1,0,2,-10,22,22,0,0,100
5,1,0,2,-9,21,21,0,0,100
5,1,0,2,-8,52,55,3,5.5,94.5
5,1,0,2,-7,80,85,5,5.9,94.1
5,1,0,2,-6,143,153,10,6.5,93.5
5,1,0,2,-5,239,264,25,9.5,90.5
5,1,0,2,-4,324,398,74,18.6,81.4
5,1,0,2,-3,456,615,159,25.9,74.1
5,1,0,2,-2,601,907,306,33.7,66.3
5,1,0,2,-1,634,1277,643,50.4,49.6
5,1,0,2,0,540,1618,1078,66.6,33.4
5,1,0,2,1,269,1311,1042,79.5,20.5
5,1,0,2,2,137,1101,964,87.6,12.4
5,1,0,2,3,46,816,770,94.4,5.60000000000001
5,1,0,2,4,26,515,489,95,5
5,1,0,2,5,10,339,329,97.1,2.90000000000001
5,1,0,2,6,2,213,211,99.1,0.900000000000006
5,1,0,2,7,1,98,97,99,1
5,1,0,2,8,0,68,68,100,0
5,1,0,2,9,0,29,29,100,0
5,1,0,2,10,0,15,15,100,0
5,1,0,2,11,0,10,10,100,0
5,1,0,2,12,0,7,7,100,0
5,1,0,2,13,0,2,2,100,0
5,1,0,2,14,0,1,1,100,0
5,1,0,12,-18,1,1,0,0,100
5,1,0,12,-14,1,1,0,0,100
5,1,0,12,-13,1,1,0,0,100
5,1,0,12,-12,5,5,0,0,100
5,1,0,12,-11,15,15,0,0,100
5,1,0,12,-10,12,12,0,0,100
5,1,0,12,-9,37,37,0,0,100
5,1,0,12,-8,57,60,3,5,95
5,1,0,12,-7,105,111,6,5.4,94.6
5,1,0,12,-6,159,181,22,12.2,87.8
5,1,0,12,-5,236,277,41,14.8,85.2
5,1,0,12,-4,291,372,81,21.8,78.2
5,1,0,12,-3,403,592,189,31.9,68.1
5,1,0,12,-2,512,858,346,40.3,59.7
5,1,0,12,-1,382,904,522,57.7,42.3
5,1,0,12,0,347,1123,776,69.1,30.9
5,1,0,12,1,169,931,762,81.8,18.2
5,1,0,12,2,81,694,613,88.3,11.7
5,1,0,12,3,28,533,505,94.7,5.30000000000001
5,1,0,12,4,19,377,358,95,5
5,1,0,12,5,8,288,280,97.2,2.8
5,1,0,12,6,3,194,191,98.5,1.5
5,1,0,12,7,1,117,116,99.1,0.900000000000006
5,1,0,12,8,0,55,55,100,0
5,1,0,12,9,1,41,40,97.6,2.40000000000001
5,1,0,12,10,0,24,24,100,0
5,1,0,12,11,0,14,14,100,0
5,1,0,12,12,0,7,7,100,0
5,1,0,12,13,0,1,1,100,0
5,1,0,12,14,0,1,1,100,0
5,1,0,12,16,0,1,1,100,0
5,1,0,12,18,0,1,1,100,0
5,1,0,3,-13,1,1,0,0,100
5,1,0,3,-10,2,2,0,0,100
5,1,0,3,-9,7,7,0,0,100
5,1,0,3,-8,11,11,0,0,100
5,1,0,3,-7,14,14,0,0,100
5,1,0,3,-6,27,28,1,3.6,96.4
5,1,0,3,-5,33,39,6,15.4,84.6
5,1,0,3,-4,34,42,8,19,81
5,1,0,3,-3,73,104,31,29.8,70.2
5,1,0,3,-2,87,144,57,39.6,60.4
5,1,0,3,-1,111,236,125,53,47
5,1,0,3,0,97,322,225,69.9,30.1
5,1,0,3,1,52,309,257,83.2,16.8
5,1,0,3,2,28,238,210,88.2,11.8
5,1,0,3,3,8,204,196,96.1,3.90000000000001
5,1,0,3,4,4,116,112,96.6,3.40000000000001
5,1,0,3,5,2,72,70,97.2,2.8
5,1,0,3,6,1,50,49,98,2
5,1,0,3,7,0,22,22,100,0
5,1,0,3,8,0,19,19,100,0
5,1,0,3,9,0,2,2,100,0
5,1,0,3,10,0,4,4,100,0
5,1,0,3,11,0,2,2,100,0
5,1,0,3,12,0,1,1,100,0
5,1,0,3,13,0,2,2,100,0
5,1,0,13,-16,1,1,0,0,100
5,1,0,13,-13,1,1,0,0,100
5,1,0,13,-12,1,1,0,0,100
5,1,0,13,-11,2,2,0,0,100
5,1,0,13,-10,10,10,0,0,100
5,1,0,13,-9,6,6,0,0,100
5,1,0,13,-8,13,13,0,0,100
5,1,0,13,-7,30,32,2,6.2,93.8
5,1,0,13,-6,38,44,6,13.6,86.4
5,1,0,13,-5,72,86,14,16.3,83.7
5,1,0,13,-4,90,114,24,21.1,78.9
5,1,0,13,-3,117,187,70,37.4,62.6
5,1,0,13,-2,154,291,137,47.1,52.9
5,1,0,13,-1,170,427,257,60.2,39.8
5,1,0,13,0,139,498,359,72.1,27.9
5,1,0,13,1,83,475,392,82.5,17.5
5,1,0,13,2,40,376,336,89.4,10.6
5,1,0,13,3,17,307,290,94.5,5.5
5,1,0,13,4,0,189,189,100,0
5,1,0,13,5,2,138,136,98.6,1.40000000000001
5,1,0,13,6,2,80,78,97.5,2.5
5,1,0,13,7,0,34,34,100,0
5,1,0,13,8,0,21,21,100,0
5,1,0,13,9,0,6,6,100,0
5,1,0,13,10,0,6,6,100,0
5,1,0,13,11,0,1,1,100,0
5,1,0,13,12,0,2,2,100,0
5,1,0,13,13,0,2,2,100,0
5,1,0,13,14,0,1,1,100,0
5,1,0,23,-13,1,1,0,0,100
5,1,0,23,-12,3,3,0,0,100
5,1,0,23,-11,1,1,0,0,100
5,1,0,23,-10,4,4,0,0,100
5,1,0,23,-9,6,6,0,0,100
5,1,0,23,-8,13,13,0,0,100
5,1,0,23,-7,24,30,6,20,80
5,1,0,23,-6,33,36,3,8.3,91.7
5,1,0,23,-5,47,58,11,19,81
5,1,0,23,-4,62,87,25,28.7,71.3
5,1,0,23,-3,80,132,52,39.4,60.6
5,1,0,23,-2,74,152,78,51.3,48.7
5,1,0,23,-1,101,240,139,57.9,42.1
5,1,0,23,0,62,298,236,79.2,20.8
5,1,0,23,1,33,240,207,86.2,13.8
5,1,0,23,2,20,212,192,90.6,9.39999999999999
5,1,0,23,3,6,175,169,96.6,3.40000000000001
5,1,0,23,4,3,141,138,97.9,2.10000000000001
5,1,0,23,5,3,90,87,96.7,3.3
5,1,0,23,6,0,49,49,100,0
5,1,0,23,7,1,41,40,97.6,2.40000000000001
5,1,0,23,8,0,20,20,100,0
5,1,0,23,9,0,10,10,100,0
5,1,0,23,10,0,11,11,100,0
5,1,0,23,11,0,4,4,100,0
5,1,0,23,12,0,2,2,100,0
5,1,0,123,-18,1,1,0,0,100
5,1,0,123,-14,1,1,0,0,100
5,1,0,123,-13,2,2,0,0,100
5,1,0,123,-12,2,2,0,0,100
5,1,0,123,-11,6,6,0,0,100
5,1,0,123,-10,7,7,0,0,100
5,1,0,123,-9,7,7,0,0,100
5,1,0,123,-8,10,12,2,16.7,83.3
5,1,0,123,-7,27,31,4,12.9,87.1
5,1,0,123,-6,34,46,12,26.1,73.9
5,1,0,123,-5,47,59,12,20.3,79.7
5,1,0,123,-4,50,77,27,35.1,64.9
5,1,0,123,-3,64,146,82,56.2,43.8
5,1,0,123,-2,89,198,109,55.1,44.9
5,1,0,123,-1,75,242,167,69,31
5,1,0,123,0,60,281,221,78.6,21.4
5,1,0,123,1,33,257,224,87.2,12.8
5,1,0,123,2,20,234,214,91.5,8.5
5,1,0,123,3,10,173,163,94.2,5.80000000000001
5,1,0,123,4,2,111,109,98.2,1.8
5,1,0,123,5,1,92,91,98.9,1.09999999999999
5,1,0,123,6,0,55,55,100,0
5,1,0,123,7,1,44,43,97.7,2.3
5,1,0,123,8,0,22,22,100,0
5,1,0,123,9,1,14,13,92.9,7.09999999999999
5,1,0,123,10,0,6,6,100,0
5,1,0,123,11,0,3,3,100,0
5,1,0,123,12,0,2,2,100,0
5,1,0,123,14,0,1,1,100,0
5,1,1,0,-19,1,1,0,0,100
5,1,1,0,-18,2,2,0,0,100
5,1,1,0,-17,3,3,0,0,100
5,1,1,0,-16,5,5,0,0,100
5,1,1,0,-15,8,8,0,0,100
5,1,1,0,-14,14,14,0,0,100
5,1,1,0,-13,46,46,0,0,100
5,1,1,0,-12,75,76,1,1.3,98.7
5,1,1,0,-11,119,119,0,0,100
5,1,1,0,-10,188,188,0,0,100
5,1,1,0,-9,343,345,2,0.6,99.4
5,1,1,0,-8,641,650,9,1.4,98.6
5,1,1,0,-7,1095,1113,18,1.6,98.4
5,1,1,0,-6,1729,1784,55,3.1,96.9
5,1,1,0,-5,2747,2923,176,6,94
5,1,1,0,-4,4188,4617,429,9.3,90.7
5,1,1,0,-3,5617,6713,1096,16.3,83.7
5,1,1,0,-2,7259,9718,2459,25.3,74.7
5,1,1,0,-1,8088,12962,4874,37.6,62.4
5,1,1,0,0,7189,15912,8723,54.8,45.2
5,1,1,0,1,3672,12844,9172,71.4,28.6
5,1,1,0,2,1604,9145,7541,82.5,17.5
5,1,1,0,3,698,6281,5583,88.9,11.1
5,1,1,0,4,254,4088,3834,93.8,6.2
5,1,1,0,5,89,2638,2549,96.6,3.40000000000001
5,1,1,0,6,28,1536,1508,98.2,1.8
5,1,1,0,7,10,982,972,99,1
5,1,1,0,8,4,565,561,99.3,0.700000000000003
5,1,1,0,9,2,328,326,99.4,0.599999999999994
5,1,1,0,10,0,184,184,100,0
5,1,1,0,11,0,96,96,100,0
5,1,1,0,12,0,49,49,100,0
5,1,1,0,13,0,24,24,100,0
5,1,1,0,14,0,20,20,100,0
5,1,1,0,15,0,10,10,100,0
5,1,1,0,16,0,3,3,100,0
5,1,1,0,17,0,3,3,100,0
5,1,1,0,18,0,1,1,100,0
5,1,1,1,-19,1,1,0,0,100
5,1,1,1,-18,1,1,0,0,100
5,1,1,1,-16,2,2,0,0,100
5,1,1,1,-15,6,6,0,0,100
5,1,1,1,-14,2,2,0,0,100
5,1,1,1,-13,29,29,0,0,100
5,1,1,1,-12,30,30,0,0,100
5,1,1,1,-11,50,50,0,0,100
5,1,1,1,-10,82,82,0,0,100
5,1,1,1,-9,140,140,0,0,100
5,1,1,1,-8,281,286,5,1.7,98.3
5,1,1,1,-7,453,468,15,3.2,96.8
5,1,1,1,-6,732,763,31,4.1,95.9
5,1,1,1,-5,1135,1229,94,7.6,92.4
5,1,1,1,-4,1664,1890,226,12,88
5,1,1,1,-3,2172,2679,507,18.9,81.1
5,1,1,1,-2,2838,4035,1197,29.7,70.3
5,1,1,1,-1,2951,5080,2129,41.9,58.1
5,1,1,1,0,2649,6269,3620,57.7,42.3
5,1,1,1,1,1356,5224,3868,74,26
5,1,1,1,2,644,3872,3228,83.4,16.6
5,1,1,1,3,259,2791,2532,90.7,9.3
5,1,1,1,4,105,1859,1754,94.4,5.60000000000001
5,1,1,1,5,27,1170,1143,97.7,2.3
5,1,1,1,6,15,735,720,98,2
5,1,1,1,7,4,470,466,99.1,0.900000000000006
5,1,1,1,8,2,279,277,99.3,0.700000000000003
5,1,1,1,9,3,171,168,98.2,1.8
5,1,1,1,10,0,94,94,100,0
5,1,1,1,11,0,38,38,100,0
5,1,1,1,12,0,24,24,100,0
5,1,1,1,13,0,6,6,100,0
5,1,1,1,14,0,5,5,100,0
5,1,1,1,15,0,5,5,100,0
5,1,1,1,17,0,1,1,100,0
5,1,1,1,18,0,1,1,100,0
5,1,1,2,-14,4,4,0,0,100
5,1,1,2,-13,2,2,0,0,100
5,1,1,2,-12,13,13,0,0,100
5,1,1,2,-11,16,16,0,0,100
5,1,1,2,-10,31,31,0,0,100
5,1,1,2,-9,46,47,1,2.1,97.9
5,1,1,2,-8,93,95,2,2.1,97.9
5,1,1,2,-7,146,151,5,3.3,96.7
5,1,1,2,-6,244,261,17,6.5,93.5
5,1,1,2,-5,362,403,41,10.2,89.8
5,1,1,2,-4,570,652,82,12.6,87.4
5,1,1,2,-3,795,974,179,18.4,81.6
5,1,1,2,-2,1021,1517,496,32.7,67.3
5,1,1,2,-1,1312,2376,1064,44.8,55.2
5,1,1,2,0,1242,3132,1890,60.3,39.7
5,1,1,2,1,716,2783,2067,74.3,25.7
5,1,1,2,2,301,2148,1847,86,14
5,1,1,2,3,129,1521,1392,91.5,8.5
5,1,1,2,4,46,986,940,95.3,4.7
5,1,1,2,5,20,654,634,96.9,3.10000000000001
5,1,1,2,6,10,377,367,97.3,2.7
5,1,1,2,7,3,191,188,98.4,1.59999999999999
5,1,1,2,8,1,137,136,99.3,0.700000000000003
5,1,1,2,9,0,68,68,100,0
5,1,1,2,10,0,30,30,100,0
5,1,1,2,11,0,22,22,100,0
5,1,1,2,12,0,10,10,100,0
5,1,1,2,13,0,7,7,100,0
5,1,1,2,14,0,2,2,100,0
5,1,1,2,15,0,1,1,100,0
5,1,1,12,-17,1,1,0,0,100
5,1,1,12,-15,1,1,0,0,100
5,1,1,12,-13,4,4,0,0,100
5,1,1,12,-12,10,10,0,0,100
5,1,1,12,-11,18,18,0,0,100
5,1,1,12,-10,28,28,0,0,100
5,1,1,12,-9,48,48,0,0,100
5,1,1,12,-8,91,95,4,4.2,95.8
5,1,1,12,-7,167,173,6,3.5,96.5
5,1,1,12,-6,273,290,17,5.9,94.1
5,1,1,12,-5,393,446,53,11.9,88.1
5,1,1,12,-4,517,633,116,18.3,81.7
5,1,1,12,-3,718,942,224,23.8,76.2
5,1,1,12,-2,834,1313,479,36.5,63.5
5,1,1,12,-1,762,1589,827,52,48
5,1,1,12,0,749,2036,1287,63.2,36.8
5,1,1,12,1,417,1878,1461,77.8,22.2
5,1,1,12,2,191,1525,1334,87.5,12.5
5,1,1,12,3,94,1098,1004,91.4,8.59999999999999
5,1,1,12,4,35,801,766,95.6,4.40000000000001
5,1,1,12,5,13,490,477,97.3,2.7
5,1,1,12,6,7,340,333,97.9,2.10000000000001
5,1,1,12,7,1,202,201,99.5,0.5
5,1,1,12,8,1,131,130,99.2,0.799999999999997
5,1,1,12,9,3,75,72,96,4
5,1,1,12,10,0,38,38,100,0
5,1,1,12,11,0,30,30,100,0
5,1,1,12,12,0,14,14,100,0
5,1,1,12,13,0,10,10,100,0
5,1,1,12,14,0,3,3,100,0
5,1,1,12,15,0,2,2,100,0
5,1,1,3,-14,1,1,0,0,100
5,1,1,3,-13,1,1,0,0,100
5,1,1,3,-12,2,2,0,0,100
5,1,1,3,-11,6,6,0,0,100
5,1,1,3,-10,11,11,0,0,100
5,1,1,3,-9,13,13,0,0,100
5,1,1,3,-8,23,23,0,0,100
5,1,1,3,-7,37,39,2,5.1,94.9
5,1,1,3,-6,55,58,3,5.2,94.8
5,1,1,3,-5,100,109,9,8.3,91.7
5,1,1,3,-4,152,182,30,16.5,83.5
5,1,1,3,-3,244,310,66,21.3,78.7
5,1,1,3,-2,319,475,156,32.8,67.2
5,1,1,3,-1,403,798,395,49.5,50.5
5,1,1,3,0,376,1080,704,65.2,34.8
5,1,1,3,1,207,954,747,78.3,21.7
5,1,1,3,2,113,773,660,85.4,14.6
5,1,1,3,3,44,617,573,92.9,7.09999999999999
5,1,1,3,4,20,379,359,94.7,5.30000000000001
5,1,1,3,5,6,222,216,97.3,2.7
5,1,1,3,6,1,151,150,99.3,0.700000000000003
5,1,1,3,7,0,82,82,100,0
5,1,1,3,8,1,59,58,98.3,1.7
5,1,1,3,9,0,24,24,100,0
5,1,1,3,10,0,11,11,100,0
5,1,1,3,11,0,10,10,100,0
5,1,1,3,12,0,3,3,100,0
5,1,1,3,13,0,1,1,100,0
5,1,1,13,-16,1,1,0,0,100
5,1,1,13,-13,3,3,0,0,100
5,1,1,13,-12,2,2,0,0,100
5,1,1,13,-11,7,7,0,0,100
5,1,1,13,-10,11,11,0,0,100
5,1,1,13,-9,15,15,0,0,100
5,1,1,13,-8,40,40,0,0,100
5,1,1,13,-7,68,74,6,8.1,91.9
5,1,1,13,-6,94,100,6,6,94
5,1,1,13,-5,149,174,25,14.4,85.6
5,1,1,13,-4,216,265,49,18.5,81.5
5,1,1,13,-3,281,392,111,28.3,71.7
5,1,1,13,-2,346,539,193,35.8,64.2
5,1,1,13,-1,396,787,391,49.7,50.3
5,1,1,13,0,350,1037,687,66.2,33.8
5,1,1,13,1,196,969,773,79.8,20.2
5,1,1,13,2,95,806,711,88.2,11.8
5,1,1,13,3,41,627,586,93.5,6.5
5,1,1,13,4,21,394,373,94.7,5.30000000000001
5,1,1,13,5,4,271,267,98.5,1.5
5,1,1,13,6,7,169,162,95.9,4.10000000000001
5,1,1,13,7,1,112,111,99.1,0.900000000000006
5,1,1,13,8,0,60,60,100,0
5,1,1,13,9,0,43,43,100,0
5,1,1,13,10,0,27,27,100,0
5,1,1,13,11,0,15,15,100,0
5,1,1,13,12,0,6,6,100,0
5,1,1,13,13,0,3,3,100,0
5,1,1,23,-13,2,2,0,0,100
5,1,1,23,-12,5,5,0,0,100
5,1,1,23,-11,4,4,0,0,100
5,1,1,23,-10,3,3,0,0,100
5,1,1,23,-9,16,16,0,0,100
5,1,1,23,-8,16,16,0,0,100
5,1,1,23,-7,33,34,1,2.9,97.1
5,1,1,23,-6,67,72,5,6.9,93.1
5,1,1,23,-5,106,117,11,9.4,90.6
5,1,1,23,-4,123,160,37,23.1,76.9
5,1,1,23,-3,168,243,75,30.9,69.1
5,1,1,23,-2,284,500,216,43.2,56.8
5,1,1,23,-1,258,557,299,53.7,46.3
5,1,1,23,0,230,769,539,70.1,29.9
5,1,1,23,1,120,696,576,82.8,17.2
5,1,1,23,2,69,579,510,88.1,11.9
5,1,1,23,3,30,497,467,94,6
5,1,1,23,4,12,325,313,96.3,3.7
5,1,1,23,5,5,224,219,97.8,2.2
5,1,1,23,6,2,133,131,98.5,1.5
5,1,1,23,7,0,86,86,100,0
5,1,1,23,8,0,49,49,100,0
5,1,1,23,9,0,29,29,100,0
5,1,1,23,10,1,20,19,95,5
5,1,1,23,11,0,13,13,100,0
5,1,1,23,12,0,2,2,100,0
5,1,1,23,13,0,1,1,100,0
5,1,1,23,14,0,1,1,100,0
5,1,1,23,17,0,2,2,100,0
5,1,1,123,-13,2,2,0,0,100
5,1,1,123,-12,2,2,0,0,100
5,1,1,123,-11,5,5,0,0,100
5,1,1,123,-10,8,8,0,0,100
5,1,1,123,-9,10,10,0,0,100
5,1,1,123,-8,11,11,0,0,100
5,1,1,123,-7,38,41,3,7.3,92.7
5,1,1,123,-6,63,74,11,14.9,85.1
5,1,1,123,-5,87,108,21,19.4,80.6
5,1,1,123,-4,124,157,33,21,79
5,1,1,123,-3,162,241,79,32.8,67.2
5,1,1,123,-2,219,380,161,42.4,57.6
5,1,1,123,-1,220,515,295,57.3,42.7
5,1,1,123,0,212,747,535,71.6,28.4
5,1,1,123,1,134,754,620,82.2,17.8
5,1,1,123,2,82,709,627,88.4,11.6
5,1,1,123,3,38,535,497,92.9,7.09999999999999
5,1,1,123,4,18,376,358,95.2,4.80000000000001
5,1,1,123,5,3,241,238,98.8,1.2
5,1,1,123,6,2,143,141,98.6,1.40000000000001
5,1,1,123,7,1,91,90,98.9,1.09999999999999
5,1,1,123,8,0,52,52,100,0
5,1,1,123,9,0,29,29,100,0
5,1,1,123,10,0,22,22,100,0
5,1,1,123,11,0,9,9,100,0
5,1,1,123,12,0,7,7,100,0
5,1,1,123,13,0,2,2,100,0
5,1,1,123,14,0,2,2,100,0
5,1,1,123,15,0,2,2,100,0
5,1,1,123,16,0,1,1,100,0
5,1,2,0,-18,2,2,0,0,100
5,1,2,0,-17,3,3,0,0,100
5,1,2,0,-16,4,4,0,0,100
5,1,2,0,-15,5,5,0,0,100
5,1,2,0,-14,13,13,0,0,100
5,1,2,0,-13,30,30,0,0,100
5,1,2,0,-12,55,56,1,1.8,98.2
5,1,2,0,-11,78,78,0,0,100
5,1,2,0,-10,130,130,0,0,100
5,1,2,0,-9,261,263,2,0.8,99.2
5,1,2,0,-8,469,475,6,1.3,98.7
5,1,2,0,-7,807,819,12,1.5,98.5
5,1,2,0,-6,1319,1354,35,2.6,97.4
5,1,2,0,-5,2142,2247,105,4.7,95.3
5,1,2,0,-4,3226,3500,274,7.8,92.2
5,1,2,0,-3,4420,5167,747,14.5,85.5
5,1,2,0,-2,5695,7389,1694,22.9,77.1
5,1,2,0,-1,6572,10136,3564,35.2,64.8
5,1,2,0,0,5862,12379,6517,52.6,47.4
5,1,2,0,1,3111,10290,7179,69.8,30.2
5,1,2,0,2,1385,7493,6108,81.5,18.5
5,1,2,0,3,611,5262,4651,88.4,11.6
5,1,2,0,4,218,3530,3312,93.8,6.2
5,1,2,0,5,96,2389,2293,96,4
5,1,2,0,6,26,1413,1387,98.2,1.8
5,1,2,0,7,9,908,899,99,1
5,1,2,0,8,3,489,486,99.4,0.599999999999994
5,1,2,0,9,1,278,277,99.6,0.400000000000006
5,1,2,0,10,0,169,169,100,0
5,1,2,0,11,0,109,109,100,0
5,1,2,0,12,0,55,55,100,0
5,1,2,0,13,0,26,26,100,0
5,1,2,0,14,0,15,15,100,0
5,1,2,0,15,0,10,10,100,0
5,1,2,0,16,0,3,3,100,0
5,1,2,0,17,0,3,3,100,0
5,1,2,0,18,0,2,2,100,0
5,1,2,1,-18,1,1,0,0,100
5,1,2,1,-16,2,2,0,0,100
5,1,2,1,-15,4,4,0,0,100
5,1,2,1,-14,5,5,0,0,100
5,1,2,1,-13,22,22,0,0,100
5,1,2,1,-12,36,36,0,0,100
5,1,2,1,-11,44,44,0,0,100
5,1,2,1,-10,74,74,0,0,100
5,1,2,1,-9,152,152,0,0,100
5,1,2,1,-8,252,255,3,1.2,98.8
5,1,2,1,-7,461,468,7,1.5,98.5
5,1,2,1,-6,718,743,25,3.4,96.6
5,1,2,1,-5,1159,1218,59,4.8,95.2
5,1,2,1,-4,1628,1804,176,9.8,90.2
5,1,2,1,-3,2265,2696,431,16,84
5,1,2,1,-2,2835,3811,976,25.6,74.4
5,1,2,1,-1,3065,4946,1881,38,62
5,1,2,1,0,2684,5984,3300,55.1,44.9
5,1,2,1,1,1498,5232,3734,71.4,28.6
5,1,2,1,2,733,4069,3336,82,18
5,1,2,1,3,299,2988,2689,90,10
5,1,2,1,4,127,2108,1981,94,6
5,1,2,1,5,51,1401,1350,96.4,3.60000000000001
5,1,2,1,6,20,865,845,97.7,2.3
5,1,2,1,7,11,572,561,98.1,1.90000000000001
5,1,2,1,8,2,363,361,99.4,0.599999999999994
5,1,2,1,9,1,220,219,99.5,0.5
5,1,2,1,10,0,112,112,100,0
5,1,2,1,11,0,78,78,100,0
5,1,2,1,12,0,33,33,100,0
5,1,2,1,13,0,14,14,100,0
5,1,2,1,14,0,8,8,100,0
5,1,2,1,15,0,4,4,100,0
5,1,2,1,16,0,2,2,100,0
5,1,2,1,17,0,4,4,100,0
5,1,2,1,18,0,3,3,100,0
5,1,2,1,19,0,2,2,100,0
5,1,2,1,20,0,1,1,100,0
5,1,2,2,-18,1,1,0,0,100
5,1,2,2,-14,3,3,0,0,100
5,1,2,2,-13,4,4,0,0,100
5,1,2,2,-12,12,12,0,0,100
5,1,2,2,-11,23,23,0,0,100
5,1,2,2,-10,36,36,0,0,100
5,1,2,2,-9,45,46,1,2.2,97.8
5,1,2,2,-8,90,91,1,1.1,98.9
5,1,2,2,-7,147,148,1,0.7,99.3
5,1,2,2,-6,261,277,16,5.8,94.2
5,1,2,2,-5,457,486,29,6,94
5,1,2,2,-4,725,796,71,8.9,91.1
5,1,2,2,-3,1015,1201,186,15.5,84.5
5,1,2,2,-2,1345,1853,508,27.4,72.6
5,1,2,2,-1,1731,2887,1156,40,60
5,1,2,2,0,1662,3814,2152,56.4,43.6
5,1,2,2,1,901,3321,2420,72.9,27.1
5,1,2,2,2,436,2594,2158,83.2,16.8
5,1,2,2,3,202,1888,1686,89.3,10.7
5,1,2,2,4,73,1372,1299,94.7,5.30000000000001
5,1,2,2,5,24,947,923,97.5,2.5
5,1,2,2,6,7,574,567,98.8,1.2
5,1,2,2,7,5,349,344,98.6,1.40000000000001
5,1,2,2,8,2,199,197,99,1
5,1,2,2,9,0,106,106,100,0
5,1,2,2,10,0,59,59,100,0
5,1,2,2,11,0,37,37,100,0
5,1,2,2,12,0,28,28,100,0
5,1,2,2,13,0,12,12,100,0
5,1,2,2,14,0,7,7,100,0
5,1,2,2,15,0,2,2,100,0
5,1,2,2,16,0,1,1,100,0
5,1,2,2,17,0,1,1,100,0
5,1,2,2,18,0,1,1,100,0
5,1,2,12,-18,1,1,0,0,100
5,1,2,12,-15,3,3,0,0,100
5,1,2,12,-14,2,2,0,0,100
5,1,2,12,-13,7,7,0,0,100
5,1,2,12,-12,21,21,0,0,100
5,1,2,12,-11,24,24,0,0,100
5,1,2,12,-10,24,24,0,0,100
5,1,2,12,-9,53,53,0,0,100
5,1,2,12,-8,96,97,1,1,99
5,1,2,12,-7,180,184,4,2.2,97.8
5,1,2,12,-6,282,296,14,4.7,95.3
5,1,2,12,-5,443,478,35,7.3,92.7
5,1,2,12,-4,627,709,82,11.6,88.4
5,1,2,12,-3,883,1084,201,18.5,81.5
5,1,2,12,-2,1057,1491,434,29.1,70.9
5,1,2,12,-1,1130,2024,894,44.2,55.8
5,1,2,12,0,1176,2718,1542,56.7,43.3
5,1,2,12,1,668,2556,1888,73.9,26.1
5,1,2,12,2,354,2086,1732,83,17
5,1,2,12,3,166,1615,1449,89.7,10.3
5,1,2,12,4,52,1207,1155,95.7,4.3
5,1,2,12,5,30,755,725,96,4
5,1,2,12,6,11,527,516,97.9,2.10000000000001
5,1,2,12,7,4,299,295,98.7,1.3
5,1,2,12,8,1,186,185,99.5,0.5
5,1,2,12,9,0,125,125,100,0
5,1,2,12,10,0,76,76,100,0
5,1,2,12,11,0,48,48,100,0
5,1,2,12,12,0,21,21,100,0
5,1,2,12,13,0,22,22,100,0
5,1,2,12,14,0,9,9,100,0
5,1,2,12,15,0,3,3,100,0
5,1,2,12,16,0,1,1,100,0
5,1,2,12,17,0,1,1,100,0
5,1,2,12,18,0,2,2,100,0
5,1,2,12,19,0,2,2,100,0
5,1,2,12,20,0,2,2,100,0
5,1,2,3,-13,3,3,0,0,100
5,1,2,3,-12,5,5,0,0,100
5,1,2,3,-11,8,8,0,0,100
5,1,2,3,-10,16,16,0,0,100
5,1,2,3,-9,20,20,0,0,100
5,1,2,3,-8,38,38,0,0,100
5,1,2,3,-7,74,77,3,3.9,96.1
5,1,2,3,-6,113,118,5,4.2,95.8
5,1,2,3,-5,167,177,10,5.6,94.4
5,1,2,3,-4,295,327,32,9.8,90.2
5,1,2,3,-3,397,465,68,14.6,85.4
5,1,2,3,-2,498,698,200,28.7,71.3
5,1,2,3,-1,650,1094,444,40.6,59.4
5,1,2,3,0,624,1406,782,55.6,44.4
5,1,2,3,1,378,1338,960,71.7,28.3
5,1,2,3,2,195,1078,883,81.9,18.1
5,1,2,3,3,77,760,683,89.9,10.1
5,1,2,3,4,35,516,481,93.2,6.8
5,1,2,3,5,17,374,357,95.5,4.5
5,1,2,3,6,4,241,237,98.3,1.7
5,1,2,3,7,3,151,148,98,2
5,1,2,3,8,1,106,105,99.1,0.900000000000006
5,1,2,3,9,0,59,59,100,0
5,1,2,3,10,0,29,29,100,0
5,1,2,3,11,0,12,12,100,0
5,1,2,3,12,0,8,8,100,0
5,1,2,3,13,0,5,5,100,0
5,1,2,3,16,0,2,2,100,0
5,1,2,3,18,0,1,1,100,0
5,1,2,13,-16,1,1,0,0,100
5,1,2,13,-13,4,4,0,0,100
5,1,2,13,-12,5,5,0,0,100
5,1,2,13,-11,5,5,0,0,100
5,1,2,13,-10,19,19,0,0,100
5,1,2,13,-9,25,25,0,0,100
5,1,2,13,-8,47,47,0,0,100
5,1,2,13,-7,67,67,0,0,100
5,1,2,13,-6,122,127,5,3.9,96.1
5,1,2,13,-5,202,210,8,3.8,96.2
5,1,2,13,-4,269,305,36,11.8,88.2
5,1,2,13,-3,391,490,99,20.2,79.8
5,1,2,13,-2,474,669,195,29.1,70.9
5,1,2,13,-1,564,984,420,42.7,57.3
5,1,2,13,0,560,1293,733,56.7,43.3
5,1,2,13,1,360,1255,895,71.3,28.7
5,1,2,13,2,184,1080,896,83,17
5,1,2,13,3,77,862,785,91.1,8.89999999999999
5,1,2,13,4,28,578,550,95.2,4.80000000000001
5,1,2,13,5,12,389,377,96.9,3.10000000000001
5,1,2,13,6,4,235,231,98.3,1.7
5,1,2,13,7,0,175,175,100,0
5,1,2,13,8,4,107,103,96.3,3.7
5,1,2,13,9,0,55,55,100,0
5,1,2,13,10,0,33,33,100,0
5,1,2,13,11,0,32,32,100,0
5,1,2,13,12,0,17,17,100,0
5,1,2,13,13,0,3,3,100,0
5,1,2,13,14,0,3,3,100,0
5,1,2,13,17,0,1,1,100,0
5,1,2,13,18,0,2,2,100,0
5,1,2,23,-12,5,5,0,0,100
5,1,2,23,-11,7,7,0,0,100
5,1,2,23,-10,4,4,0,0,100
5,1,2,23,-9,14,14,0,0,100
5,1,2,23,-8,28,28,0,0,100
5,1,2,23,-7,36,38,2,5.3,94.7
5,1,2,23,-6,71,75,4,5.3,94.7
5,1,2,23,-5,123,133,10,7.5,92.5
5,1,2,23,-4,165,188,23,12.2,87.8
5,1,2,23,-3,203,257,54,21,79
5,1,2,23,-2,287,424,137,32.3,67.7
5,1,2,23,-1,284,527,243,46.1,53.9
5,1,2,23,0,326,816,490,60,40
5,1,2,23,1,173,705,532,75.5,24.5
5,1,2,23,2,83,579,496,85.7,14.3
5,1,2,23,3,40,508,468,92.1,7.89999999999999
5,1,2,23,4,17,344,327,95.1,4.90000000000001
5,1,2,23,5,3,270,267,98.9,1.09999999999999
5,1,2,23,6,1,166,165,99.4,0.599999999999994
5,1,2,23,7,1,105,104,99,1
5,1,2,23,8,0,65,65,100,0
5,1,2,23,9,0,34,34,100,0
5,1,2,23,10,1,28,27,96.4,3.60000000000001
5,1,2,23,11,0,14,14,100,0
5,1,2,23,12,0,5,5,100,0
5,1,2,23,13,0,4,4,100,0
5,1,2,23,15,0,1,1,100,0
5,1,2,23,16,0,1,1,100,0
5,1,2,23,17,0,1,1,100,0
5,1,2,23,18,0,1,1,100,0
5,1,2,123,-13,1,1,0,0,100
5,1,2,123,-12,4,4,0,0,100
5,1,2,123,-11,4,4,0,0,100
5,1,2,123,-10,8,8,0,0,100
5,1,2,123,-9,14,14,0,0,100
5,1,2,123,-8,21,21,0,0,100
5,1,2,123,-7,38,39,1,2.6,97.4
5,1,2,123,-6,75,82,7,8.5,91.5
5,1,2,123,-5,112,119,7,5.9,94.1
5,1,2,123,-4,154,176,22,12.5,87.5
5,1,2,123,-3,224,294,70,23.8,76.2
5,1,2,123,-2,278,430,152,35.3,64.7
5,1,2,123,-1,319,614,295,48,52
5,1,2,123,0,342,921,579,62.9,37.1
5,1,2,123,1,226,930,704,75.7,24.3
5,1,2,123,2,108,828,720,87,13
5,1,2,123,3,74,674,600,89,11
5,1,2,123,4,25,460,435,94.6,5.40000000000001
5,1,2,123,5,8,311,303,97.4,2.60000000000001
5,1,2,123,6,3,196,193,98.5,1.5
5,1,2,123,7,0,136,136,100,0
5,1,2,123,8,0,84,84,100,0
5,1,2,123,9,0,45,45,100,0
5,1,2,123,10,1,30,29,96.7,3.3
5,1,2,123,11,0,22,22,100,0
5,1,2,123,12,0,10,10,100,0
5,1,2,123,13,0,2,2,100,0
5,1,2,123,14,0,6,6,100,0
5,1,2,123,15,0,2,2,100,0
5,1,2,123,20,0,1,1,100,0
6,0,0,0,-20,1,1,0,0,100
6,0,0,0,-19,2,2,0,0,100
6,0,0,0,-18,4,4,0,0,100
6,0,0,0,-17,5,5,0,0,100
6,0,0,0,-16,7,7,0,0,100
6,0,0,0,-15,10,10,0,0,100
6,0,0,0,-14,23,23,0,0,100
6,0,0,0,-13,59,59,0,0,100
6,0,0,0,-12,92,93,1,1.1,98.9
6,0,0,0,-11,149,149,0,0,100
6,0,0,0,-10,241,241,0,0,100
6,0,0,0,-9,449,451,2,0.4,99.6
6,0,0,0,-8,819,826,7,0.8,99.2
6,0,0,0,-7,1353,1375,22,1.6,98.4
6,0,0,0,-6,2266,2318,52,2.2,97.8
6,0,0,0,-5,3712,3892,180,4.6,95.4
6,0,0,0,-4,5482,5917,435,7.4,92.6
6,0,0,0,-3,7628,8791,1163,13.2,86.8
6,0,0,0,-2,9868,12653,2785,22,78
6,0,0,0,-1,11174,16879,5705,33.8,66.2
6,0,0,0,0,10120,20600,10480,50.9,49.1
6,0,0,0,1,5639,17777,12138,68.3,31.7
6,0,0,0,2,2683,13603,10920,80.3,19.7
6,0,0,0,3,1162,9965,8803,88.3,11.7
6,0,0,0,4,463,6977,6514,93.4,6.59999999999999
6,0,0,0,5,195,4764,4569,95.9,4.10000000000001
6,0,0,0,6,60,2980,2920,98,2
6,0,0,0,7,25,1907,1882,98.7,1.3
6,0,0,0,8,9,1137,1128,99.2,0.799999999999997
6,0,0,0,9,6,645,639,99.1,0.900000000000006
6,0,0,0,10,1,373,372,99.7,0.299999999999997
6,0,0,0,11,0,233,233,100,0
6,0,0,0,12,0,122,122,100,0
6,0,0,0,13,0,57,57,100,0
6,0,0,0,14,0,30,30,100,0
6,0,0,0,15,0,19,19,100,0
6,0,0,0,16,0,5,5,100,0
6,0,0,0,17,0,7,7,100,0
6,0,0,0,18,0,3,3,100,0
6,0,0,0,19,0,2,2,100,0
6,0,0,0,20,0,2,2,100,0
6,0,0,1,-19,1,1,0,0,100
6,0,0,1,-18,3,3,0,0,100
6,0,0,1,-17,3,3,0,0,100
6,0,0,1,-16,3,3,0,0,100
6,0,0,1,-15,5,5,0,0,100
6,0,0,1,-14,5,5,0,0,100
6,0,0,1,-13,12,12,0,0,100
6,0,0,1,-12,29,29,0,0,100
6,0,0,1,-11,39,39,0,0,100
6,0,0,1,-10,57,57,0,0,100
6,0,0,1,-9,118,118,0,0,100
6,0,0,1,-8,209,209,0,0,100
6,0,0,1,-7,354,361,7,1.9,98.1
6,0,0,1,-6,634,648,14,2.2,97.8
6,0,0,1,-5,941,986,45,4.6,95.4
6,0,0,1,-4,1399,1505,106,7,93
6,0,0,1,-3,2019,2292,273,11.9,88.1
6,0,0,1,-2,2593,3242,649,20,80
6,0,0,1,-1,3036,4308,1272,29.5,70.5
6,0,0,1,0,2744,5114,2370,46.3,53.7
6,0,0,1,1,1711,4587,2876,62.7,37.3
6,0,0,1,2,882,3551,2669,75.2,24.8
6,0,0,1,3,391,2559,2168,84.7,15.3
6,0,0,1,4,147,1778,1631,91.7,8.3
6,0,0,1,5,61,1232,1171,95,5
6,0,0,1,6,21,703,682,97,3
6,0,0,1,7,11,489,478,97.8,2.2
6,0,0,1,8,4,274,270,98.5,1.5
6,0,0,1,9,1,143,142,99.3,0.700000000000003
6,0,0,1,10,0,103,103,100,0
6,0,0,1,11,0,60,60,100,0
6,0,0,1,12,0,38,38,100,0
6,0,0,1,13,0,19,19,100,0
6,0,0,1,14,0,6,6,100,0
6,0,0,1,15,0,5,5,100,0
6,0,0,1,16,0,1,1,100,0
6,0,0,1,17,0,3,3,100,0
6,0,0,1,18,0,1,1,100,0
6,0,0,1,19,0,1,1,100,0
6,0,0,2,-19,1,1,0,0,100
6,0,0,2,-18,1,1,0,0,100
6,0,0,2,-16,2,2,0,0,100
6,0,0,2,-15,1,1,0,0,100
6,0,0,2,-14,3,3,0,0,100
6,0,0,2,-13,6,6,0,0,100
6,0,0,2,-12,6,6,0,0,100
6,0,0,2,-11,21,21,0,0,100
6,0,0,2,-10,18,18,0,0,100
6,0,0,2,-9,40,40,0,0,100
6,0,0,2,-8,67,67,0,0,100
6,0,0,2,-7,87,87,0,0,100
6,0,0,2,-6,190,195,5,2.6,97.4
6,0,0,2,-5,310,330,20,6.1,93.9
6,0,0,2,-4,439,470,31,6.6,93.4
6,0,0,2,-3,631,707,76,10.7,89.3
6,0,0,2,-2,803,991,188,19,81
6,0,0,2,-1,954,1305,351,26.9,73.1
6,0,0,2,0,844,1434,590,41.1,58.9
6,0,0,2,1,492,1176,684,58.2,41.8
6,0,0,2,2,250,836,586,70.1,29.9
6,0,0,2,3,109,653,544,83.3,16.7
6,0,0,2,4,53,461,408,88.5,11.5
6,0,0,2,5,16,312,296,94.9,5.10000000000001
6,0,0,2,6,8,179,171,95.5,4.5
6,0,0,2,7,3,122,119,97.5,2.5
6,0,0,2,8,0,78,78,100,0
6,0,0,2,9,1,30,29,96.7,3.3
6,0,0,2,10,0,28,28,100,0
6,0,0,2,11,0,10,10,100,0
6,0,0,2,12,0,10,10,100,0
6,0,0,2,14,0,1,1,100,0
6,0,0,12,-17,2,2,0,0,100
6,0,0,12,-15,3,3,0,0,100
6,0,0,12,-14,3,3,0,0,100
6,0,0,12,-13,3,3,0,0,100
6,0,0,12,-12,11,11,0,0,100
6,0,0,12,-11,14,14,0,0,100
6,0,0,12,-10,25,25,0,0,100
6,0,0,12,-9,43,43,0,0,100
6,0,0,12,-8,85,85,0,0,100
6,0,0,12,-7,111,111,0,0,100
6,0,0,12,-6,158,163,5,3.1,96.9
6,0,0,12,-5,214,220,6,2.7,97.3
6,0,0,12,-4,314,331,17,5.1,94.9
6,0,0,12,-3,439,483,44,9.1,90.9
6,0,0,12,-2,596,723,127,17.6,82.4
6,0,0,12,-1,700,918,218,23.7,76.3
6,0,0,12,0,622,1013,391,38.6,61.4
6,0,0,12,1,439,977,538,55.1,44.9
6,0,0,12,2,308,939,631,67.2,32.8
6,0,0,12,3,169,655,486,74.2,25.8
6,0,0,12,4,63,447,384,85.9,14.1
6,0,0,12,5,20,322,302,93.8,6.2
6,0,0,12,6,6,173,167,96.5,3.5
6,0,0,12,7,4,120,116,96.7,3.3
6,0,0,12,8,1,70,69,98.6,1.40000000000001
6,0,0,12,9,0,31,31,100,0
6,0,0,12,10,0,30,30,100,0
6,0,0,12,11,0,17,17,100,0
6,0,0,12,12,0,10,10,100,0
6,0,0,12,13,0,2,2,100,0
6,0,0,12,14,0,2,2,100,0
6,0,0,12,15,0,1,1,100,0
6,0,0,12,17,0,1,1,100,0
6,0,0,12,19,0,1,1,100,0
6,0,0,3,-11,2,2,0,0,100
6,0,0,3,-10,6,6,0,0,100
6,0,0,3,-9,5,5,0,0,100
6,0,0,3,-8,11,11,0,0,100
6,0,0,3,-7,21,21,0,0,100
6,0,0,3,-6,35,35,0,0,100
6,0,0,3,-5,58,59,1,1.7,98.3
6,0,0,3,-4,93,97,4,4.1,95.9
6,0,0,3,-3,132,145,13,9,91
6,0,0,3,-2,169,206,37,18,82
6,0,0,3,-1,186,233,47,20.2,79.8
6,0,0,3,0,172,263,91,34.6,65.4
6,0,0,3,1,102,197,95,48.2,51.8
6,0,0,3,2,51,152,101,66.4,33.6
6,0,0,3,3,14,96,82,85.4,14.6
6,0,0,3,4,9,75,66,88,12
6,0,0,3,5,6,43,37,86,14
6,0,0,3,6,1,37,36,97.3,2.7
6,0,0,3,7,0,19,19,100,0
6,0,0,3,8,1,12,11,91.7,8.3
6,0,0,3,9,1,7,6,85.7,14.3
6,0,0,3,10,0,5,5,100,0
6,0,0,3,11,0,1,1,100,0
6,0,0,3,13,0,2,2,100,0
6,0,0,13,-16,1,1,0,0,100
6,0,0,13,-14,2,2,0,0,100
6,0,0,13,-13,2,2,0,0,100
6,0,0,13,-12,3,3,0,0,100
6,0,0,13,-11,9,9,0,0,100
6,0,0,13,-10,9,9,0,0,100
6,0,0,13,-9,24,24,0,0,100
6,0,0,13,-8,30,30,0,0,100
6,0,0,13,-7,46,46,0,0,100
6,0,0,13,-6,65,67,2,3,97
6,0,0,13,-5,109,116,7,6,94
6,0,0,13,-4,147,155,8,5.2,94.8
6,0,0,13,-3,218,235,17,7.2,92.8
6,0,0,13,-2,292,340,48,14.1,85.9
6,0,0,13,-1,304,382,78,20.4,79.6
6,0,0,13,0,325,456,131,28.7,71.3
6,0,0,13,1,217,427,210,49.2,50.8
6,0,0,13,2,104,292,188,64.4,35.6
6,0,0,13,3,45,211,166,78.7,21.3
6,0,0,13,4,21,153,132,86.3,13.7
6,0,0,13,5,7,84,77,91.7,8.3
6,0,0,13,6,5,63,58,92.1,7.89999999999999
6,0,0,13,7,0,39,39,100,0
6,0,0,13,8,1,21,20,95.2,4.80000000000001
6,0,0,13,9,0,10,10,100,0
6,0,0,13,10,0,13,13,100,0
6,0,0,13,11,0,2,2,100,0
6,0,0,13,12,0,1,1,100,0
6,0,0,23,-16,1,1,0,0,100
6,0,0,23,-14,2,2,0,0,100
6,0,0,23,-13,1,1,0,0,100
6,0,0,23,-12,2,2,0,0,100
6,0,0,23,-11,2,2,0,0,100
6,0,0,23,-10,5,5,0,0,100
6,0,0,23,-9,16,16,0,0,100
6,0,0,23,-8,19,19,0,0,100
6,0,0,23,-7,34,34,0,0,100
6,0,0,23,-6,39,39,0,0,100
6,0,0,23,-5,67,69,2,2.9,97.1
6,0,0,23,-4,88,91,3,3.3,96.7
6,0,0,23,-3,118,127,9,7.1,92.9
6,0,0,23,-2,182,205,23,11.2,88.8
6,0,0,23,-1,185,237,52,21.9,78.1
6,0,0,23,0,205,283,78,27.6,72.4
6,0,0,23,1,136,243,107,44,56
6,0,0,23,2,81,195,114,58.5,41.5
6,0,0,23,3,28,150,122,81.3,18.7
6,0,0,23,4,12,85,73,85.9,14.1
6,0,0,23,5,6,68,62,91.2,8.8
6,0,0,23,6,2,38,36,94.7,5.30000000000001
6,0,0,23,7,0,25,25,100,0
6,0,0,23,8,0,18,18,100,0
6,0,0,23,9,0,9,9,100,0
6,0,0,23,10,0,7,7,100,0
6,0,0,23,11,0,2,2,100,0
6,0,0,23,12,0,3,3,100,0
6,0,0,23,13,0,1,1,100,0
6,0,0,23,16,0,1,1,100,0
6,0,0,123,-12,4,4,0,0,100
6,0,0,123,-11,4,4,0,0,100
6,0,0,123,-10,9,9,0,0,100
6,0,0,123,-9,13,13,0,0,100
6,0,0,123,-8,33,33,0,0,100
6,0,0,123,-7,30,30,0,0,100
6,0,0,123,-6,44,45,1,2.2,97.8
6,0,0,123,-5,64,64,0,0,100
6,0,0,123,-4,100,104,4,3.8,96.2
6,0,0,123,-3,116,123,7,5.7,94.3
6,0,0,123,-2,180,200,20,10,90
6,0,0,123,-1,215,263,48,18.3,81.7
6,0,0,123,0,172,242,70,28.9,71.1
6,0,0,123,1,133,226,93,41.2,58.8
6,0,0,123,2,78,196,118,60.2,39.8
6,0,0,123,3,49,156,107,68.6,31.4
6,0,0,123,4,19,108,89,82.4,17.6
6,0,0,123,5,7,74,67,90.5,9.5
6,0,0,123,6,4,35,31,88.6,11.4
6,0,0,123,7,1,30,29,96.7,3.3
6,0,0,123,8,2,11,9,81.8,18.2
6,0,0,123,9,0,6,6,100,0
6,0,0,123,10,0,8,8,100,0
6,0,0,123,11,0,2,2,100,0
6,0,0,123,13,0,1,1,100,0
6,0,1,0,-21,1,1,0,0,100
6,0,1,0,-20,1,1,0,0,100
6,0,1,0,-18,1,1,0,0,100
6,0,1,0,-17,2,2,0,0,100
6,0,1,0,-16,5,5,0,0,100
6,0,1,0,-15,8,8,0,0,100
6,0,1,0,-14,22,22,0,0,100
6,0,1,0,-13,48,48,0,0,100
6,0,1,0,-12,74,75,1,1.3,98.7
6,0,1,0,-11,130,130,0,0,100
6,0,1,0,-10,199,199,0,0,100
6,0,1,0,-9,372,374,2,0.5,99.5
6,0,1,0,-8,660,667,7,1,99
6,0,1,0,-7,1039,1056,17,1.6,98.4
6,0,1,0,-6,1691,1731,40,2.3,97.7
6,0,1,0,-5,2811,2956,145,4.9,95.1
6,0,1,0,-4,4130,4476,346,7.7,92.3
6,0,1,0,-3,5617,6531,914,14,86
6,0,1,0,-2,7135,9295,2160,23.2,76.8
6,0,1,0,-1,7708,12124,4416,36.4,63.6
6,0,1,0,0,6744,14660,7916,54,46
6,0,1,0,1,3527,12519,8992,71.8,28.2
6,0,1,0,2,1552,9456,7904,83.6,16.4
6,0,1,0,3,666,6893,6227,90.3,9.7
6,0,1,0,4,266,4838,4572,94.5,5.5
6,0,1,0,5,103,3250,3147,96.8,3.2
6,0,1,0,6,26,2106,2080,98.8,1.2
6,0,1,0,7,9,1307,1298,99.3,0.700000000000003
6,0,1,0,8,5,792,787,99.4,0.599999999999994
6,0,1,0,9,3,457,454,99.3,0.700000000000003
6,0,1,0,10,1,247,246,99.6,0.400000000000006
6,0,1,0,11,0,159,159,100,0
6,0,1,0,12,0,73,73,100,0
6,0,1,0,13,0,39,39,100,0
6,0,1,0,14,0,25,25,100,0
6,0,1,0,15,0,14,14,100,0
6,0,1,0,16,0,4,4,100,0
6,0,1,0,17,0,3,3,100,0
6,0,1,0,18,0,2,2,100,0
6,0,1,0,19,0,1,1,100,0
6,0,1,0,20,0,2,2,100,0
6,0,1,1,-20,1,1,0,0,100
6,0,1,1,-19,2,2,0,0,100
6,0,1,1,-18,1,1,0,0,100
6,0,1,1,-17,1,1,0,0,100
6,0,1,1,-16,6,6,0,0,100
6,0,1,1,-15,6,6,0,0,100
6,0,1,1,-14,4,4,0,0,100
6,0,1,1,-13,19,19,0,0,100
6,0,1,1,-12,33,33,0,0,100
6,0,1,1,-11,60,60,0,0,100
6,0,1,1,-10,82,82,0,0,100
6,0,1,1,-9,186,186,0,0,100
6,0,1,1,-8,257,259,2,0.8,99.2
6,0,1,1,-7,483,492,9,1.8,98.2
6,0,1,1,-6,810,835,25,3,97
6,0,1,1,-5,1235,1297,62,4.8,95.2
6,0,1,1,-4,1740,1860,120,6.5,93.5
6,0,1,1,-3,2386,2721,335,12.3,87.7
6,0,1,1,-2,2928,3755,827,22,78
6,0,1,1,-1,3397,5074,1677,33.1,66.9
6,0,1,1,0,2834,5774,2940,50.9,49.1
6,0,1,1,1,1618,5050,3432,68,32
6,0,1,1,2,822,4080,3258,79.9,20.1
6,0,1,1,3,342,2924,2582,88.3,11.7
6,0,1,1,4,126,2070,1944,93.9,6.10000000000001
6,0,1,1,5,63,1432,1369,95.6,4.40000000000001
6,0,1,1,6,16,912,896,98.2,1.8
6,0,1,1,7,10,527,517,98.1,1.90000000000001
6,0,1,1,8,3,320,317,99.1,0.900000000000006
6,0,1,1,9,0,171,171,100,0
6,0,1,1,10,0,114,114,100,0
6,0,1,1,11,0,64,64,100,0
6,0,1,1,12,0,34,34,100,0
6,0,1,1,13,0,22,22,100,0
6,0,1,1,14,0,12,12,100,0
6,0,1,1,15,0,4,4,100,0
6,0,1,1,16,0,2,2,100,0
6,0,1,1,17,0,1,1,100,0
6,0,1,1,19,0,1,1,100,0
6,0,1,2,-19,1,1,0,0,100
6,0,1,2,-18,1,1,0,0,100
6,0,1,2,-16,1,1,0,0,100
6,0,1,2,-15,1,1,0,0,100
6,0,1,2,-14,6,6,0,0,100
6,0,1,2,-13,8,8,0,0,100
6,0,1,2,-12,14,14,0,0,100
6,0,1,2,-11,28,28,0,0,100
6,0,1,2,-10,50,50,0,0,100
6,0,1,2,-9,88,88,0,0,100
6,0,1,2,-8,134,134,0,0,100
6,0,1,2,-7,210,212,2,0.9,99.1
6,0,1,2,-6,386,393,7,1.8,98.2
6,0,1,2,-5,631,666,35,5.3,94.7
6,0,1,2,-4,943,1028,85,8.3,91.7
6,0,1,2,-3,1222,1405,183,13,87
6,0,1,2,-2,1540,1893,353,18.6,81.4
6,0,1,2,-1,1648,2352,704,29.9,70.1
6,0,1,2,0,1437,2792,1355,48.5,51.5
6,0,1,2,1,745,2144,1399,65.3,34.7
6,0,1,2,2,291,1379,1088,78.9,21.1
6,0,1,2,3,122,938,816,87,13
6,0,1,2,4,49,669,620,92.7,7.3
6,0,1,2,5,10,403,393,97.5,2.5
6,0,1,2,6,12,278,266,95.7,4.3
6,0,1,2,7,3,197,194,98.5,1.5
6,0,1,2,8,1,113,112,99.1,0.900000000000006
6,0,1,2,9,0,54,54,100,0
6,0,1,2,10,0,37,37,100,0
6,0,1,2,11,0,19,19,100,0
6,0,1,2,12,0,18,18,100,0
6,0,1,2,13,0,3,3,100,0
6,0,1,2,14,0,3,3,100,0
6,0,1,2,15,0,6,6,100,0
6,0,1,2,16,0,1,1,100,0
6,0,1,12,-20,1,1,0,0,100
6,0,1,12,-18,1,1,0,0,100
6,0,1,12,-16,3,3,0,0,100
6,0,1,12,-15,3,3,0,0,100
6,0,1,12,-14,2,2,0,0,100
6,0,1,12,-13,8,8,0,0,100
6,0,1,12,-12,16,16,0,0,100
6,0,1,12,-11,27,27,0,0,100
6,0,1,12,-10,57,57,0,0,100
6,0,1,12,-9,80,80,0,0,100
6,0,1,12,-8,138,138,0,0,100
6,0,1,12,-7,225,229,4,1.7,98.3
6,0,1,12,-6,340,350,10,2.9,97.1
6,0,1,12,-5,468,486,18,3.7,96.3
6,0,1,12,-4,642,685,43,6.3,93.7
6,0,1,12,-3,905,1017,112,11,89
6,0,1,12,-2,1099,1386,287,20.7,79.3
6,0,1,12,-1,1263,1798,535,29.8,70.2
6,0,1,12,0,996,1934,938,48.5,51.5
6,0,1,12,1,619,1646,1027,62.4,37.6
6,0,1,12,2,350,1391,1041,74.8,25.2
6,0,1,12,3,166,1039,873,84,16
6,0,1,12,4,63,665,602,90.5,9.5
6,0,1,12,5,27,467,440,94.2,5.80000000000001
6,0,1,12,6,9,298,289,97,3
6,0,1,12,7,4,188,184,97.9,2.10000000000001
6,0,1,12,8,2,100,98,98,2
6,0,1,12,9,0,46,46,100,0
6,0,1,12,10,0,34,34,100,0
6,0,1,12,11,0,23,23,100,0
6,0,1,12,12,0,10,10,100,0
6,0,1,12,13,0,5,5,100,0
6,0,1,12,14,0,3,3,100,0
6,0,1,12,15,0,1,1,100,0
6,0,1,12,16,0,1,1,100,0
6,0,1,12,17,0,1,1,100,0
6,0,1,12,19,0,1,1,100,0
6,0,1,3,-19,1,1,0,0,100
6,0,1,3,-18,1,1,0,0,100
6,0,1,3,-14,1,1,0,0,100
6,0,1,3,-13,8,8,0,0,100
6,0,1,3,-12,5,5,0,0,100
6,0,1,3,-11,10,10,0,0,100
6,0,1,3,-10,13,13,0,0,100
6,0,1,3,-9,25,25,0,0,100
6,0,1,3,-8,26,27,1,3.7,96.3
6,0,1,3,-7,74,74,0,0,100
6,0,1,3,-6,154,156,2,1.3,98.7
6,0,1,3,-5,202,215,13,6,94
6,0,1,3,-4,325,355,30,8.5,91.5
6,0,1,3,-3,426,472,46,9.7,90.3
6,0,1,3,-2,545,639,94,14.7,85.3
6,0,1,3,-1,623,857,234,27.3,72.7
6,0,1,3,0,518,906,388,42.8,57.2
6,0,1,3,1,292,688,396,57.6,42.4
6,0,1,3,2,104,423,319,75.4,24.6
6,0,1,3,3,43,311,268,86.2,13.8
6,0,1,3,4,18,191,173,90.6,9.39999999999999
6,0,1,3,5,3,133,130,97.7,2.3
6,0,1,3,6,0,54,54,100,0
6,0,1,3,7,0,49,49,100,0
6,0,1,3,8,0,25,25,100,0
6,0,1,3,9,0,15,15,100,0
6,0,1,3,10,0,8,8,100,0
6,0,1,3,11,0,6,6,100,0
6,0,1,3,12,0,4,4,100,0
6,0,1,3,13,0,2,2,100,0
6,0,1,3,14,0,1,1,100,0
6,0,1,13,-17,1,1,0,0,100
6,0,1,13,-16,1,1,0,0,100
6,0,1,13,-15,2,2,0,0,100
6,0,1,13,-14,2,2,0,0,100
6,0,1,13,-13,6,6,0,0,100
6,0,1,13,-12,11,11,0,0,100
6,0,1,13,-11,14,14,0,0,100
6,0,1,13,-10,18,18,0,0,100
6,0,1,13,-9,58,58,0,0,100
6,0,1,13,-8,64,64,0,0,100
6,0,1,13,-7,93,93,0,0,100
6,0,1,13,-6,176,180,4,2.2,97.8
6,0,1,13,-5,239,247,8,3.2,96.8
6,0,1,13,-4,363,387,24,6.2,93.8
6,0,1,13,-3,475,524,49,9.4,90.6
6,0,1,13,-2,606,736,130,17.7,82.3
6,0,1,13,-1,647,892,245,27.5,72.5
6,0,1,13,0,567,933,366,39.2,60.8
6,0,1,13,1,304,753,449,59.6,40.4
6,0,1,13,2,166,562,396,70.5,29.5
6,0,1,13,3,72,393,321,81.7,18.3
6,0,1,13,4,32,302,270,89.4,10.6
6,0,1,13,5,11,191,180,94.2,5.80000000000001
6,0,1,13,6,3,117,114,97.4,2.60000000000001
6,0,1,13,7,4,82,78,95.1,4.90000000000001
6,0,1,13,8,0,36,36,100,0
6,0,1,13,9,0,22,22,100,0
6,0,1,13,10,0,22,22,100,0
6,0,1,13,11,0,10,10,100,0
6,0,1,13,12,0,4,4,100,0
6,0,1,13,13,0,1,1,100,0
6,0,1,23,-14,2,2,0,0,100
6,0,1,23,-13,3,3,0,0,100
6,0,1,23,-12,2,2,0,0,100
6,0,1,23,-11,10,10,0,0,100
6,0,1,23,-10,18,18,0,0,100
6,0,1,23,-9,32,32,0,0,100
6,0,1,23,-8,38,38,0,0,100
6,0,1,23,-7,78,78,0,0,100
6,0,1,23,-6,127,128,1,0.8,99.2
6,0,1,23,-5,207,212,5,2.4,97.6
6,0,1,23,-4,296,308,12,3.9,96.1
6,0,1,23,-3,404,450,46,10.2,89.8
6,0,1,23,-2,437,529,92,17.4,82.6
6,0,1,23,-1,472,633,161,25.4,74.6
6,0,1,23,0,423,697,274,39.3,60.7
6,0,1,23,1,271,595,324,54.5,45.5
6,0,1,23,2,146,408,262,64.2,35.8
6,0,1,23,3,46,240,194,80.8,19.2
6,0,1,23,4,17,160,143,89.4,10.6
6,0,1,23,5,8,104,96,92.3,7.69999999999999
6,0,1,23,6,2,78,76,97.4,2.60000000000001
6,0,1,23,7,2,48,46,95.8,4.2
6,0,1,23,8,0,21,21,100,0
6,0,1,23,9,0,19,19,100,0
6,0,1,23,10,0,11,11,100,0
6,0,1,23,11,0,6,6,100,0
6,0,1,23,12,0,3,3,100,0
6,0,1,23,13,0,1,1,100,0
6,0,1,23,14,0,1,1,100,0
6,0,1,123,-19,1,1,0,0,100
6,0,1,123,-18,1,1,0,0,100
6,0,1,123,-16,2,2,0,0,100
6,0,1,123,-15,1,1,0,0,100
6,0,1,123,-14,2,2,0,0,100
6,0,1,123,-13,2,2,0,0,100
6,0,1,123,-12,6,6,0,0,100
6,0,1,123,-11,11,11,0,0,100
6,0,1,123,-10,18,18,0,0,100
6,0,1,123,-9,38,38,0,0,100
6,0,1,123,-8,64,64,0,0,100
6,0,1,123,-7,86,86,0,0,100
6,0,1,123,-6,135,137,2,1.5,98.5
6,0,1,123,-5,207,209,2,1,99
6,0,1,123,-4,293,306,13,4.2,95.8
6,0,1,123,-3,438,478,40,8.4,91.6
6,0,1,123,-2,510,596,86,14.4,85.6
6,0,1,123,-1,581,756,175,23.1,76.9
6,0,1,123,0,447,722,275,38.1,61.9
6,0,1,123,1,260,575,315,54.8,45.2
6,0,1,123,2,122,381,259,68,32
6,0,1,123,3,71,278,207,74.5,25.5
6,0,1,123,4,24,173,149,86.1,13.9
6,0,1,123,5,6,124,118,95.2,4.80000000000001
6,0,1,123,6,5,81,76,93.8,6.2
6,0,1,123,7,2,51,49,96.1,3.90000000000001
6,0,1,123,8,0,18,18,100,0
6,0,1,123,9,0,14,14,100,0
6,0,1,123,10,0,10,10,100,0
6,0,1,123,11,0,5,5,100,0
6,0,1,123,12,0,2,2,100,0
6,0,1,123,14,0,1,1,100,0
6,0,1,123,15,0,1,1,100,0
6,0,1,123,16,0,1,1,100,0
6,0,2,0,-21,2,2,0,0,100
6,0,2,0,-18,1,1,0,0,100
6,0,2,0,-17,3,3,0,0,100
6,0,2,0,-16,6,6,0,0,100
6,0,2,0,-15,12,12,0,0,100
6,0,2,0,-14,25,25,0,0,100
6,0,2,0,-13,50,50,0,0,100
6,0,2,0,-12,80,81,1,1.2,98.8
6,0,2,0,-11,131,131,0,0,100
6,0,2,0,-10,198,198,0,0,100
6,0,2,0,-9,334,336,2,0.6,99.4
6,0,2,0,-8,609,613,4,0.7,99.3
6,0,2,0,-7,919,938,19,2,98
6,0,2,0,-6,1476,1514,38,2.5,97.5
6,0,2,0,-5,2406,2521,115,4.6,95.4
6,0,2,0,-4,3451,3767,316,8.4,91.6
6,0,2,0,-3,4705,5516,811,14.7,85.3
6,0,2,0,-2,5687,7594,1907,25.1,74.9
6,0,2,0,-1,5914,9626,3712,38.6,61.4
6,0,2,0,0,4929,11351,6422,56.6,43.4
6,0,2,0,1,2476,9732,7256,74.6,25.4
6,0,2,0,2,1016,7184,6168,85.9,14.1
6,0,2,0,3,441,5247,4806,91.6,8.39999999999999
6,0,2,0,4,163,3649,3486,95.5,4.5
6,0,2,0,5,63,2418,2355,97.4,2.60000000000001
6,0,2,0,6,11,1529,1518,99.3,0.700000000000003
6,0,2,0,7,6,984,978,99.4,0.599999999999994
6,0,2,0,8,3,591,588,99.5,0.5
6,0,2,0,9,3,353,350,99.2,0.799999999999997
6,0,2,0,10,1,181,180,99.4,0.599999999999994
6,0,2,0,11,0,126,126,100,0
6,0,2,0,12,0,49,49,100,0
6,0,2,0,13,0,31,31,100,0
6,0,2,0,14,0,13,13,100,0
6,0,2,0,15,0,8,8,100,0
6,0,2,0,16,0,2,2,100,0
6,0,2,0,17,0,4,4,100,0
6,0,2,0,18,0,3,3,100,0
6,0,2,0,20,0,2,2,100,0
6,0,2,1,-19,1,1,0,0,100
6,0,2,1,-18,2,2,0,0,100
6,0,2,1,-17,2,2,0,0,100
6,0,2,1,-16,6,6,0,0,100
6,0,2,1,-15,3,3,0,0,100
6,0,2,1,-14,12,12,0,0,100
6,0,2,1,-13,30,30,0,0,100
6,0,2,1,-12,48,48,0,0,100
6,0,2,1,-11,88,88,0,0,100
6,0,2,1,-10,131,131,0,0,100
6,0,2,1,-9,232,232,0,0,100
6,0,2,1,-8,377,381,4,1,99
6,0,2,1,-7,584,601,17,2.8,97.2
6,0,2,1,-6,915,939,24,2.6,97.4
6,0,2,1,-5,1372,1451,79,5.4,94.6
6,0,2,1,-4,1886,2028,142,7,93
6,0,2,1,-3,2516,2932,416,14.2,85.8
6,0,2,1,-2,2932,3884,952,24.5,75.5
6,0,2,1,-1,3165,4966,1801,36.3,63.7
6,0,2,1,0,2567,5688,3121,54.9,45.1
6,0,2,1,1,1392,4929,3537,71.8,28.2
6,0,2,1,2,600,3722,3122,83.9,16.1
6,0,2,1,3,258,2814,2556,90.8,9.2
6,0,2,1,4,97,1982,1885,95.1,4.90000000000001
6,0,2,1,5,42,1343,1301,96.9,3.10000000000001
6,0,2,1,6,11,846,835,98.7,1.3
6,0,2,1,7,4,518,514,99.2,0.799999999999997
6,0,2,1,8,1,311,310,99.7,0.299999999999997
6,0,2,1,9,1,171,170,99.4,0.599999999999994
6,0,2,1,10,0,109,109,100,0
6,0,2,1,11,0,65,65,100,0
6,0,2,1,12,0,36,36,100,0
6,0,2,1,13,0,23,23,100,0
6,0,2,1,14,0,8,8,100,0
6,0,2,1,15,0,2,2,100,0
6,0,2,1,16,0,1,1,100,0
6,0,2,1,17,0,2,2,100,0
6,0,2,1,18,0,1,1,100,0
6,0,2,1,19,0,1,1,100,0
6,0,2,2,-18,2,2,0,0,100
6,0,2,2,-17,1,1,0,0,100
6,0,2,2,-16,4,4,0,0,100
6,0,2,2,-15,4,4,0,0,100
6,0,2,2,-14,9,9,0,0,100
6,0,2,2,-13,19,19,0,0,100
6,0,2,2,-12,23,23,0,0,100
6,0,2,2,-11,48,48,0,0,100
6,0,2,2,-10,80,80,0,0,100
6,0,2,2,-9,127,128,1,0.8,99.2
6,0,2,2,-8,191,192,1,0.5,99.5
6,0,2,2,-7,301,305,4,1.3,98.7
6,0,2,2,-6,511,524,13,2.5,97.5
6,0,2,2,-5,912,964,52,5.4,94.6
6,0,2,2,-4,1261,1373,112,8.2,91.8
6,0,2,2,-3,1592,1833,241,13.1,86.9
6,0,2,2,-2,1880,2435,555,22.8,77.2
6,0,2,2,-1,1870,2852,982,34.4,65.6
6,0,2,2,0,1484,3211,1727,53.8,46.2
6,0,2,2,1,701,2470,1769,71.6,28.4
6,0,2,2,2,259,1685,1426,84.6,15.4
6,0,2,2,3,99,1171,1072,91.5,8.5
6,0,2,2,4,33,799,766,95.9,4.10000000000001
6,0,2,2,5,16,519,503,96.9,3.10000000000001
6,0,2,2,6,7,327,320,97.9,2.10000000000001
6,0,2,2,7,1,183,182,99.5,0.5
6,0,2,2,8,0,116,116,100,0
6,0,2,2,9,0,65,65,100,0
6,0,2,2,10,0,34,34,100,0
6,0,2,2,11,0,26,26,100,0
6,0,2,2,12,0,13,13,100,0
6,0,2,2,13,0,6,6,100,0
6,0,2,2,14,0,4,4,100,0
6,0,2,2,15,0,2,2,100,0
6,0,2,12,-20,2,2,0,0,100
6,0,2,12,-18,2,2,0,0,100
6,0,2,12,-17,4,4,0,0,100
6,0,2,12,-16,6,6,0,0,100
6,0,2,12,-15,2,2,0,0,100
6,0,2,12,-14,7,7,0,0,100
6,0,2,12,-13,13,13,0,0,100
6,0,2,12,-12,23,23,0,0,100
6,0,2,12,-11,52,52,0,0,100
6,0,2,12,-10,80,80,0,0,100
6,0,2,12,-9,130,131,1,0.8,99.2
6,0,2,12,-8,204,204,0,0,100
6,0,2,12,-7,338,343,5,1.5,98.5
6,0,2,12,-6,519,527,8,1.5,98.5
6,0,2,12,-5,702,732,30,4.1,95.9
6,0,2,12,-4,1023,1094,71,6.5,93.5
6,0,2,12,-3,1277,1472,195,13.2,86.8
6,0,2,12,-2,1529,1961,432,22,78
6,0,2,12,-1,1547,2405,858,35.7,64.3
6,0,2,12,0,1233,2607,1374,52.7,47.3
6,0,2,12,1,639,2049,1410,68.8,31.2
6,0,2,12,2,293,1565,1272,81.3,18.7
6,0,2,12,3,107,1129,1022,90.5,9.5
6,0,2,12,4,59,776,717,92.4,7.59999999999999
6,0,2,12,5,27,554,527,95.1,4.90000000000001
6,0,2,12,6,8,299,291,97.3,2.7
6,0,2,12,7,3,198,195,98.5,1.5
6,0,2,12,8,1,113,112,99.1,0.900000000000006
6,0,2,12,9,0,64,64,100,0
6,0,2,12,10,0,47,47,100,0
6,0,2,12,11,0,18,18,100,0
6,0,2,12,12,0,14,14,100,0
6,0,2,12,13,0,8,8,100,0
6,0,2,12,14,0,5,5,100,0
6,0,2,3,-17,1,1,0,0,100
6,0,2,3,-16,1,1,0,0,100
6,0,2,3,-15,1,1,0,0,100
6,0,2,3,-14,5,5,0,0,100
6,0,2,3,-13,10,10,0,0,100
6,0,2,3,-12,17,17,0,0,100
6,0,2,3,-11,21,21,0,0,100
6,0,2,3,-10,30,30,0,0,100
6,0,2,3,-9,44,44,0,0,100
6,0,2,3,-8,92,93,1,1.1,98.9
6,0,2,3,-7,114,114,0,0,100
6,0,2,3,-6,225,230,5,2.2,97.8
6,0,2,3,-5,360,384,24,6.2,93.8
6,0,2,3,-4,529,579,50,8.6,91.4
6,0,2,3,-3,636,734,98,13.4,86.6
6,0,2,3,-2,718,909,191,21,79
6,0,2,3,-1,727,1128,401,35.5,64.5
6,0,2,3,0,580,1243,663,53.3,46.7
6,0,2,3,1,294,962,668,69.4,30.6
6,0,2,3,2,118,649,531,81.8,18.2
6,0,2,3,3,41,441,400,90.7,9.3
6,0,2,3,4,24,325,301,92.6,7.39999999999999
6,0,2,3,5,6,215,209,97.2,2.8
6,0,2,3,6,0,121,121,100,0
6,0,2,3,7,0,70,70,100,0
6,0,2,3,8,0,47,47,100,0
6,0,2,3,9,0,24,24,100,0
6,0,2,3,10,0,14,14,100,0
6,0,2,3,11,0,6,6,100,0
6,0,2,3,12,0,8,8,100,0
6,0,2,3,13,0,1,1,100,0
6,0,2,3,14,0,1,1,100,0
6,0,2,3,15,0,3,3,100,0
6,0,2,3,16,0,1,1,100,0
6,0,2,13,-19,1,1,0,0,100
6,0,2,13,-16,1,1,0,0,100
6,0,2,13,-15,3,3,0,0,100
6,0,2,13,-14,5,5,0,0,100
6,0,2,13,-13,11,11,0,0,100
6,0,2,13,-12,17,17,0,0,100
6,0,2,13,-11,23,23,0,0,100
6,0,2,13,-10,35,35,0,0,100
6,0,2,13,-9,69,69,0,0,100
6,0,2,13,-8,105,107,2,1.9,98.1
6,0,2,13,-7,173,173,0,0,100
6,0,2,13,-6,283,289,6,2.1,97.9
6,0,2,13,-5,379,402,23,5.7,94.3
6,0,2,13,-4,497,541,44,8.1,91.9
6,0,2,13,-3,640,729,89,12.2,87.8
6,0,2,13,-2,739,957,218,22.8,77.2
6,0,2,13,-1,758,1145,387,33.8,66.2
6,0,2,13,0,589,1205,616,51.1,48.9
6,0,2,13,1,275,881,606,68.8,31.2
6,0,2,13,2,152,697,545,78.2,21.8
6,0,2,13,3,57,485,428,88.2,11.8
6,0,2,13,4,20,334,314,94,6
6,0,2,13,5,10,224,214,95.5,4.5
6,0,2,13,6,3,129,126,97.7,2.3
6,0,2,13,7,2,83,81,97.6,2.40000000000001
6,0,2,13,8,1,49,48,98,2
6,0,2,13,9,0,27,27,100,0
6,0,2,13,10,0,17,17,100,0
6,0,2,13,11,0,6,6,100,0
6,0,2,13,12,0,5,5,100,0
6,0,2,13,13,0,3,3,100,0
6,0,2,13,14,0,2,2,100,0
6,0,2,13,15,0,1,1,100,0
6,0,2,23,-18,1,1,0,0,100
6,0,2,23,-14,4,4,0,0,100
6,0,2,23,-13,8,8,0,0,100
6,0,2,23,-12,6,6,0,0,100
6,0,2,23,-11,14,14,0,0,100
6,0,2,23,-10,29,29,0,0,100
6,0,2,23,-9,37,37,0,0,100
6,0,2,23,-8,66,68,2,2.9,97.1
6,0,2,23,-7,88,91,3,3.3,96.7
6,0,2,23,-6,159,163,4,2.5,97.5
6,0,2,23,-5,258,272,14,5.1,94.9
6,0,2,23,-4,328,354,26,7.3,92.7
6,0,2,23,-3,421,484,63,13,87
6,0,2,23,-2,476,613,137,22.3,77.7
6,0,2,23,-1,466,675,209,31,69
6,0,2,23,0,343,661,318,48.1,51.9
6,0,2,23,1,168,540,372,68.9,31.1
6,0,2,23,2,92,401,309,77.1,22.9
6,0,2,23,3,38,279,241,86.4,13.6
6,0,2,23,4,15,200,185,92.5,7.5
6,0,2,23,5,5,127,122,96.1,3.90000000000001
6,0,2,23,6,2,82,80,97.6,2.40000000000001
6,0,2,23,7,1,49,48,98,2
6,0,2,23,8,0,25,25,100,0
6,0,2,23,9,0,14,14,100,0
6,0,2,23,10,0,8,8,100,0
6,0,2,23,11,0,10,10,100,0
6,0,2,23,12,0,1,1,100,0
6,0,2,123,-17,1,1,0,0,100
6,0,2,123,-16,2,2,0,0,100
6,0,2,123,-14,1,1,0,0,100
6,0,2,123,-13,3,3,0,0,100
6,0,2,123,-12,10,10,0,0,100
6,0,2,123,-11,21,21,0,0,100
6,0,2,123,-10,32,32,0,0,100
6,0,2,123,-9,40,40,0,0,100
6,0,2,123,-8,68,69,1,1.4,98.6
6,0,2,123,-7,119,120,1,0.8,99.2
6,0,2,123,-6,189,194,5,2.6,97.4
6,0,2,123,-5,256,267,11,4.1,95.9
6,0,2,123,-4,361,379,18,4.7,95.3
6,0,2,123,-3,463,539,76,14.1,85.9
6,0,2,123,-2,577,720,143,19.9,80.1
6,0,2,123,-1,623,859,236,27.5,72.5
6,0,2,123,0,462,886,424,47.9,52.1
6,0,2,123,1,252,663,411,62,38
6,0,2,123,2,125,488,363,74.4,25.6
6,0,2,123,3,47,334,287,85.9,14.1
6,0,2,123,4,17,208,191,91.8,8.2
6,0,2,123,5,6,141,135,95.7,4.3
6,0,2,123,6,3,78,75,96.2,3.8
6,0,2,123,7,2,53,51,96.2,3.8
6,0,2,123,8,1,21,20,95.2,4.80000000000001
6,0,2,123,9,0,9,9,100,0
6,0,2,123,10,0,7,7,100,0
6,0,2,123,11,0,1,1,100,0
6,0,2,123,12,0,3,3,100,0
6,0,2,123,13,0,2,2,100,0
6,1,0,0,-21,2,2,0,0,100
6,1,0,0,-20,2,2,0,0,100
6,1,0,0,-19,3,3,0,0,100
6,1,0,0,-18,4,4,0,0,100
6,1,0,0,-17,8,8,0,0,100
6,1,0,0,-16,16,16,0,0,100
6,1,0,0,-15,19,19,0,0,100
6,1,0,0,-14,48,48,0,0,100
6,1,0,0,-13,102,102,0,0,100
6,1,0,0,-12,159,160,1,0.6,99.4
6,1,0,0,-11,263,263,0,0,100
6,1,0,0,-10,441,441,0,0,100
6,1,0,0,-9,700,703,3,0.4,99.6
6,1,0,0,-8,1197,1207,10,0.8,99.2
6,1,0,0,-7,1862,1895,33,1.7,98.3
6,1,0,0,-6,3000,3092,92,3,97
6,1,0,0,-5,4632,4893,261,5.3,94.7
6,1,0,0,-4,6482,7097,615,8.7,91.3
6,1,0,0,-3,8532,10082,1550,15.4,84.6
6,1,0,0,-2,10182,13738,3556,25.9,74.1
6,1,0,0,-1,10300,17053,6753,39.6,60.4
6,1,0,0,0,7924,19120,11196,58.6,41.4
6,1,0,0,1,3849,16274,12425,76.3,23.7
6,1,0,0,2,1634,12463,10829,86.9,13.1
6,1,0,0,3,642,9064,8422,92.9,7.09999999999999
6,1,0,0,4,242,6379,6137,96.2,3.8
6,1,0,0,5,105,4191,4086,97.5,2.5
6,1,0,0,6,17,2647,2630,99.4,0.599999999999994
6,1,0,0,7,11,1673,1662,99.3,0.700000000000003
6,1,0,0,8,3,1002,999,99.7,0.299999999999997
6,1,0,0,9,1,596,595,99.8,0.200000000000003
6,1,0,0,10,1,352,351,99.7,0.299999999999997
6,1,0,0,11,0,215,215,100,0
6,1,0,0,12,0,104,104,100,0
6,1,0,0,13,0,56,56,100,0
6,1,0,0,14,0,32,32,100,0
6,1,0,0,15,0,16,16,100,0
6,1,0,0,16,0,6,6,100,0
6,1,0,0,17,0,5,5,100,0
6,1,0,0,18,0,3,3,100,0
6,1,0,0,19,0,2,2,100,0
6,1,0,0,20,0,2,2,100,0
6,1,0,1,-21,1,1,0,0,100
6,1,0,1,-19,1,1,0,0,100
6,1,0,1,-18,1,1,0,0,100
6,1,0,1,-17,2,2,0,0,100
6,1,0,1,-16,3,3,0,0,100
6,1,0,1,-15,4,4,0,0,100
6,1,0,1,-14,8,8,0,0,100
6,1,0,1,-13,29,29,0,0,100
6,1,0,1,-12,51,51,0,0,100
6,1,0,1,-11,62,62,0,0,100
6,1,0,1,-10,108,108,0,0,100
6,1,0,1,-9,183,184,1,0.5,99.5
6,1,0,1,-8,328,330,2,0.6,99.4
6,1,0,1,-7,450,464,14,3,97
6,1,0,1,-6,790,828,38,4.6,95.4
6,1,0,1,-5,1203,1311,108,8.2,91.8
6,1,0,1,-4,1558,1773,215,12.1,87.9
6,1,0,1,-3,2008,2529,521,20.6,79.4
6,1,0,1,-2,2466,3625,1159,32,68
6,1,0,1,-1,2391,4503,2112,46.9,53.1
6,1,0,1,0,1803,4967,3164,63.7,36.3
6,1,0,1,1,886,4252,3366,79.2,20.8
6,1,0,1,2,364,3321,2957,89,11
6,1,0,1,3,185,2440,2255,92.4,7.59999999999999
6,1,0,1,4,54,1690,1636,96.8,3.2
6,1,0,1,5,30,1119,1089,97.3,2.7
6,1,0,1,6,5,736,731,99.3,0.700000000000003
6,1,0,1,7,4,429,425,99.1,0.900000000000006
6,1,0,1,8,1,291,290,99.7,0.299999999999997
6,1,0,1,9,0,193,193,100,0
6,1,0,1,10,1,98,97,99,1
6,1,0,1,11,0,70,70,100,0
6,1,0,1,12,0,28,28,100,0
6,1,0,1,13,0,17,17,100,0
6,1,0,1,14,0,8,8,100,0
6,1,0,1,15,0,4,4,100,0
6,1,0,1,16,0,2,2,100,0
6,1,0,1,17,0,1,1,100,0
6,1,0,1,18,0,1,1,100,0
6,1,0,1,19,0,1,1,100,0
6,1,0,2,-15,1,1,0,0,100
6,1,0,2,-14,1,1,0,0,100
6,1,0,2,-13,5,5,0,0,100
6,1,0,2,-12,17,17,0,0,100
6,1,0,2,-11,18,18,0,0,100
6,1,0,2,-10,31,31,0,0,100
6,1,0,2,-9,40,40,0,0,100
6,1,0,2,-8,81,83,2,2.4,97.6
6,1,0,2,-7,115,121,6,5,95
6,1,0,2,-6,187,198,11,5.6,94.4
6,1,0,2,-5,267,292,25,8.6,91.4
6,1,0,2,-4,447,518,71,13.7,86.3
6,1,0,2,-3,534,688,154,22.4,77.6
6,1,0,2,-2,558,875,317,36.2,63.8
6,1,0,2,-1,571,1167,596,51.1,48.9
6,1,0,2,0,436,1360,924,67.9,32.1
6,1,0,2,1,217,1280,1063,83,17
6,1,0,2,2,118,1017,899,88.4,11.6
6,1,0,2,3,46,795,749,94.2,5.80000000000001
6,1,0,2,4,15,565,550,97.3,2.7
6,1,0,2,5,4,383,379,99,1
6,1,0,2,6,1,209,208,99.5,0.5
6,1,0,2,7,1,122,121,99.2,0.799999999999997
6,1,0,2,8,0,75,75,100,0
6,1,0,2,9,0,45,45,100,0
6,1,0,2,10,0,32,32,100,0
6,1,0,2,11,0,19,19,100,0
6,1,0,2,12,0,17,17,100,0
6,1,0,2,13,0,4,4,100,0
6,1,0,2,14,0,6,6,100,0
6,1,0,2,15,0,5,5,100,0
6,1,0,12,-17,1,1,0,0,100
6,1,0,12,-16,2,2,0,0,100
6,1,0,12,-15,1,1,0,0,100
6,1,0,12,-14,1,1,0,0,100
6,1,0,12,-13,4,4,0,0,100
6,1,0,12,-12,17,17,0,0,100
6,1,0,12,-11,20,20,0,0,100
6,1,0,12,-10,22,22,0,0,100
6,1,0,12,-9,39,40,1,2.5,97.5
6,1,0,12,-8,76,76,0,0,100
6,1,0,12,-7,120,124,4,3.2,96.8
6,1,0,12,-6,189,204,15,7.4,92.6
6,1,0,12,-5,297,340,43,12.6,87.4
6,1,0,12,-4,383,481,98,20.4,79.6
6,1,0,12,-3,472,679,207,30.5,69.5
6,1,0,12,-2,533,904,371,41,59
6,1,0,12,-1,403,968,565,58.4,41.6
6,1,0,12,0,280,994,714,71.8,28.2
6,1,0,12,1,145,865,720,83.2,16.8
6,1,0,12,2,72,743,671,90.3,9.7
6,1,0,12,3,19,502,483,96.2,3.8
6,1,0,12,4,7,399,392,98.2,1.8
6,1,0,12,5,6,297,291,98,2
6,1,0,12,6,0,217,217,100,0
6,1,0,12,7,0,123,123,100,0
6,1,0,12,8,0,91,91,100,0
6,1,0,12,9,0,55,55,100,0
6,1,0,12,10,0,30,30,100,0
6,1,0,12,11,0,18,18,100,0
6,1,0,12,12,0,7,7,100,0
6,1,0,12,13,0,1,1,100,0
6,1,0,12,14,0,2,2,100,0
6,1,0,12,15,0,1,1,100,0
6,1,0,3,-17,1,1,0,0,100
6,1,0,3,-12,1,1,0,0,100
6,1,0,3,-11,2,2,0,0,100
6,1,0,3,-10,3,3,0,0,100
6,1,0,3,-9,9,9,0,0,100
6,1,0,3,-8,15,16,1,6.2,93.8
6,1,0,3,-7,23,24,1,4.2,95.8
6,1,0,3,-6,35,37,2,5.4,94.6
6,1,0,3,-5,59,66,7,10.6,89.4
6,1,0,3,-4,81,92,11,12,88
6,1,0,3,-3,94,136,42,30.9,69.1
6,1,0,3,-2,122,183,61,33.3,66.7
6,1,0,3,-1,87,213,126,59.2,40.8
6,1,0,3,0,61,258,197,76.4,23.6
6,1,0,3,1,52,266,214,80.5,19.5
6,1,0,3,2,17,217,200,92.2,7.8
6,1,0,3,3,9,167,158,94.6,5.40000000000001
6,1,0,3,4,3,113,110,97.3,2.7
6,1,0,3,5,5,73,68,93.2,6.8
6,1,0,3,6,0,61,61,100,0
6,1,0,3,7,0,27,27,100,0
6,1,0,3,8,0,21,21,100,0
6,1,0,3,9,0,23,23,100,0
6,1,0,3,10,0,6,6,100,0
6,1,0,3,11,0,8,8,100,0
6,1,0,3,12,0,2,2,100,0
6,1,0,3,14,0,1,1,100,0
6,1,0,13,-15,1,1,0,0,100
6,1,0,13,-13,1,1,0,0,100
6,1,0,13,-12,2,2,0,0,100
6,1,0,13,-11,6,6,0,0,100
6,1,0,13,-10,12,12,0,0,100
6,1,0,13,-9,19,19,0,0,100
6,1,0,13,-8,24,24,0,0,100
6,1,0,13,-7,28,30,2,6.7,93.3
6,1,0,13,-6,52,55,3,5.5,94.5
6,1,0,13,-5,88,102,14,13.7,86.3
6,1,0,13,-4,121,149,28,18.8,81.2
6,1,0,13,-3,156,212,56,26.4,73.6
6,1,0,13,-2,151,291,140,48.1,51.9
6,1,0,13,-1,157,423,266,62.9,37.1
6,1,0,13,0,113,449,336,74.8,25.2
6,1,0,13,1,47,374,327,87.4,12.6
6,1,0,13,2,22,344,322,93.6,6.39999999999999
6,1,0,13,3,12,270,258,95.6,4.40000000000001
6,1,0,13,4,2,203,201,99,1
6,1,0,13,5,0,113,113,100,0
6,1,0,13,6,0,99,99,100,0
6,1,0,13,7,1,53,52,98.1,1.90000000000001
6,1,0,13,8,0,33,33,100,0
6,1,0,13,9,0,20,20,100,0
6,1,0,13,10,0,4,4,100,0
6,1,0,13,11,0,9,9,100,0
6,1,0,13,12,0,2,2,100,0
6,1,0,13,13,0,2,2,100,0
6,1,0,13,14,0,1,1,100,0
6,1,0,23,-15,1,1,0,0,100
6,1,0,23,-13,1,1,0,0,100
6,1,0,23,-12,4,4,0,0,100
6,1,0,23,-11,2,2,0,0,100
6,1,0,23,-10,6,6,0,0,100
6,1,0,23,-9,6,6,0,0,100
6,1,0,23,-8,15,15,0,0,100
6,1,0,23,-7,38,38,0,0,100
6,1,0,23,-6,45,48,3,6.2,93.8
6,1,0,23,-5,58,65,7,10.8,89.2
6,1,0,23,-4,69,92,23,25,75
6,1,0,23,-3,82,131,49,37.4,62.6
6,1,0,23,-2,118,196,78,39.8,60.2
6,1,0,23,-1,73,222,149,67.1,32.9
6,1,0,23,0,49,242,193,79.8,20.2
6,1,0,23,1,27,236,209,88.6,11.4
6,1,0,23,2,12,187,175,93.6,6.39999999999999
6,1,0,23,3,5,162,157,96.9,3.10000000000001
6,1,0,23,4,1,106,105,99.1,0.900000000000006
6,1,0,23,5,0,85,85,100,0
6,1,0,23,6,1,58,57,98.3,1.7
6,1,0,23,7,0,40,40,100,0
6,1,0,23,8,0,20,20,100,0
6,1,0,23,9,0,21,21,100,0
6,1,0,23,10,0,12,12,100,0
6,1,0,23,11,0,3,3,100,0
6,1,0,23,12,0,6,6,100,0
6,1,0,23,13,0,1,1,100,0
6,1,0,123,-13,2,2,0,0,100
6,1,0,123,-12,2,2,0,0,100
6,1,0,123,-11,2,2,0,0,100
6,1,0,123,-10,4,4,0,0,100
6,1,0,123,-9,4,4,0,0,100
6,1,0,123,-8,11,11,0,0,100
6,1,0,123,-7,20,22,2,9.1,90.9
6,1,0,123,-6,39,43,4,9.3,90.7
6,1,0,123,-5,60,73,13,17.8,82.2
6,1,0,123,-4,72,107,35,32.7,67.3
6,1,0,123,-3,86,145,59,40.7,59.3
6,1,0,123,-2,100,208,108,51.9,48.1
6,1,0,123,-1,80,251,171,68.1,31.9
6,1,0,123,0,61,267,206,77.2,22.8
6,1,0,123,1,36,260,224,86.2,13.8
6,1,0,123,2,6,218,212,97.2,2.8
6,1,0,123,3,2,154,152,98.7,1.3
6,1,0,123,4,1,131,130,99.2,0.799999999999997
6,1,0,123,5,0,76,76,100,0
6,1,0,123,6,0,67,67,100,0
6,1,0,123,7,0,38,38,100,0
6,1,0,123,8,0,25,25,100,0
6,1,0,123,9,0,21,21,100,0
6,1,0,123,10,0,7,7,100,0
6,1,0,123,11,0,6,6,100,0
6,1,0,123,12,0,2,2,100,0
6,1,0,123,13,0,1,1,100,0
6,1,0,123,14,0,1,1,100,0
6,1,1,0,-21,1,1,0,0,100
6,1,1,0,-20,2,2,0,0,100
6,1,1,0,-19,2,2,0,0,100
6,1,1,0,-18,3,3,0,0,100
6,1,1,0,-17,5,5,0,0,100
6,1,1,0,-16,14,14,0,0,100
6,1,1,0,-15,17,17,0,0,100
6,1,1,0,-14,37,37,0,0,100
6,1,1,0,-13,69,69,0,0,100
6,1,1,0,-12,92,93,1,1.1,98.9
6,1,1,0,-11,181,181,0,0,100
6,1,1,0,-10,310,310,0,0,100
6,1,1,0,-9,478,480,2,0.4,99.6
6,1,1,0,-8,785,790,5,0.6,99.4
6,1,1,0,-7,1298,1313,15,1.1,98.9
6,1,1,0,-6,2027,2070,43,2.1,97.9
6,1,1,0,-5,3169,3294,125,3.8,96.2
6,1,1,0,-4,4571,4899,328,6.7,93.3
6,1,1,0,-3,6100,6970,870,12.5,87.5
6,1,1,0,-2,7323,9388,2065,22,78
6,1,1,0,-1,7747,11865,4118,34.7,65.3
6,1,1,0,0,6098,13524,7426,54.9,45.1
6,1,1,0,1,2992,11546,8554,74.1,25.9
6,1,1,0,2,1272,8922,7650,85.7,14.3
6,1,1,0,3,476,6579,6103,92.8,7.19999999999999
6,1,1,0,4,190,4732,4542,96,4
6,1,1,0,5,80,3119,3039,97.4,2.60000000000001
6,1,1,0,6,14,1955,1941,99.3,0.700000000000003
6,1,1,0,7,6,1265,1259,99.5,0.5
6,1,1,0,8,2,741,739,99.7,0.299999999999997
6,1,1,0,9,1,441,440,99.8,0.200000000000003
6,1,1,0,10,0,282,282,100,0
6,1,1,0,11,0,171,171,100,0
6,1,1,0,12,0,91,91,100,0
6,1,1,0,13,0,48,48,100,0
6,1,1,0,14,0,30,30,100,0
6,1,1,0,15,0,11,11,100,0
6,1,1,0,16,0,7,7,100,0
6,1,1,0,17,0,4,4,100,0
6,1,1,0,18,0,2,2,100,0
6,1,1,0,19,0,1,1,100,0
6,1,1,0,20,0,2,2,100,0
6,1,1,0,21,0,1,1,100,0
6,1,1,1,-21,2,2,0,0,100
6,1,1,1,-19,1,1,0,0,100
6,1,1,1,-18,1,1,0,0,100
6,1,1,1,-17,4,4,0,0,100
6,1,1,1,-16,7,7,0,0,100
6,1,1,1,-15,7,7,0,0,100
6,1,1,1,-14,14,14,0,0,100
6,1,1,1,-13,38,38,0,0,100
6,1,1,1,-12,50,50,0,0,100
6,1,1,1,-11,83,83,0,0,100
6,1,1,1,-10,123,123,0,0,100
6,1,1,1,-9,212,213,1,0.5,99.5
6,1,1,1,-8,339,340,1,0.3,99.7
6,1,1,1,-7,548,557,9,1.6,98.4
6,1,1,1,-6,894,925,31,3.4,96.6
6,1,1,1,-5,1353,1437,84,5.8,94.2
6,1,1,1,-4,1927,2111,184,8.7,91.3
6,1,1,1,-3,2555,3037,482,15.9,84.1
6,1,1,1,-2,2990,4124,1134,27.5,72.5
6,1,1,1,-1,2981,4934,1953,39.6,60.4
6,1,1,1,0,2210,5453,3243,59.5,40.5
6,1,1,1,1,1128,4834,3706,76.7,23.3
6,1,1,1,2,509,3818,3309,86.7,13.3
6,1,1,1,3,210,2867,2657,92.7,7.3
6,1,1,1,4,79,2090,2011,96.2,3.8
6,1,1,1,5,30,1407,1377,97.9,2.10000000000001
6,1,1,1,6,7,888,881,99.2,0.799999999999997
6,1,1,1,7,6,619,613,99,1
6,1,1,1,8,1,376,375,99.7,0.299999999999997
6,1,1,1,9,1,236,235,99.6,0.400000000000006
6,1,1,1,10,1,146,145,99.3,0.700000000000003
6,1,1,1,11,0,80,80,100,0
6,1,1,1,12,0,40,40,100,0
6,1,1,1,13,0,26,26,100,0
6,1,1,1,14,0,17,17,100,0
6,1,1,1,15,0,6,6,100,0
6,1,1,1,16,0,3,3,100,0
6,1,1,1,17,0,2,2,100,0
6,1,1,1,18,0,1,1,100,0
6,1,1,1,19,0,1,1,100,0
6,1,1,2,-19,1,1,0,0,100
6,1,1,2,-16,1,1,0,0,100
6,1,1,2,-14,2,2,0,0,100
6,1,1,2,-13,7,7,0,0,100
6,1,1,2,-12,12,12,0,0,100
6,1,1,2,-11,21,21,0,0,100
6,1,1,2,-10,40,40,0,0,100
6,1,1,2,-9,69,69,0,0,100
6,1,1,2,-8,118,118,0,0,100
6,1,1,2,-7,191,195,4,2.1,97.9
6,1,1,2,-6,281,288,7,2.4,97.6
6,1,1,2,-5,451,472,21,4.4,95.6
6,1,1,2,-4,641,708,67,9.5,90.5
6,1,1,2,-3,840,1000,160,16,84
6,1,1,2,-2,977,1382,405,29.3,70.7
6,1,1,2,-1,1295,2262,967,42.7,57.3
6,1,1,2,0,1084,2819,1735,61.5,38.5
6,1,1,2,1,512,2410,1898,78.8,21.2
6,1,1,2,2,240,1986,1746,87.9,12.1
6,1,1,2,3,96,1534,1438,93.7,6.3
6,1,1,2,4,27,1101,1074,97.5,2.5
6,1,1,2,5,18,796,778,97.7,2.3
6,1,1,2,6,3,436,433,99.3,0.700000000000003
6,1,1,2,7,2,277,275,99.3,0.700000000000003
6,1,1,2,8,0,170,170,100,0
6,1,1,2,9,0,102,102,100,0
6,1,1,2,10,0,59,59,100,0
6,1,1,2,11,0,38,38,100,0
6,1,1,2,12,0,28,28,100,0
6,1,1,2,13,0,13,13,100,0
6,1,1,2,14,0,8,8,100,0
6,1,1,2,15,0,9,9,100,0
6,1,1,2,17,0,1,1,100,0
6,1,1,2,19,0,1,1,100,0
6,1,1,2,20,0,1,1,100,0
6,1,1,12,-16,4,4,0,0,100
6,1,1,12,-15,3,3,0,0,100
6,1,1,12,-14,3,3,0,0,100
6,1,1,12,-13,7,7,0,0,100
6,1,1,12,-12,20,20,0,0,100
6,1,1,12,-11,23,23,0,0,100
6,1,1,12,-10,46,46,0,0,100
6,1,1,12,-9,71,71,0,0,100
6,1,1,12,-8,114,114,0,0,100
6,1,1,12,-7,209,215,6,2.8,97.2
6,1,1,12,-6,334,355,21,5.9,94.1
6,1,1,12,-5,479,533,54,10.1,89.9
6,1,1,12,-4,697,793,96,12.1,87.9
6,1,1,12,-3,851,1060,209,19.7,80.3
6,1,1,12,-2,937,1415,478,33.8,66.2
6,1,1,12,-1,907,1728,821,47.5,52.5
6,1,1,12,0,710,2009,1299,64.7,35.3
6,1,1,12,1,346,1820,1474,81,19
6,1,1,12,2,180,1487,1307,87.9,12.1
6,1,1,12,3,72,1116,1044,93.5,6.5
6,1,1,12,4,29,811,782,96.4,3.60000000000001
6,1,1,12,5,15,648,633,97.7,2.3
6,1,1,12,6,1,439,438,99.8,0.200000000000003
6,1,1,12,7,2,286,284,99.3,0.700000000000003
6,1,1,12,8,2,173,171,98.8,1.2
6,1,1,12,9,1,114,113,99.1,0.900000000000006
6,1,1,12,10,0,73,73,100,0
6,1,1,12,11,0,42,42,100,0
6,1,1,12,12,0,30,30,100,0
6,1,1,12,13,0,8,8,100,0
6,1,1,12,14,0,5,5,100,0
6,1,1,12,15,0,3,3,100,0
6,1,1,12,16,0,4,4,100,0
6,1,1,12,17,0,3,3,100,0
6,1,1,3,-18,1,1,0,0,100
6,1,1,3,-13,3,3,0,0,100
6,1,1,3,-12,7,7,0,0,100
6,1,1,3,-11,14,14,0,0,100
6,1,1,3,-10,13,13,0,0,100
6,1,1,3,-9,14,14,0,0,100
6,1,1,3,-8,32,32,0,0,100
6,1,1,3,-7,41,41,0,0,100
6,1,1,3,-6,84,89,5,5.6,94.4
6,1,1,3,-5,115,121,6,5,95
6,1,1,3,-4,220,241,21,8.7,91.3
6,1,1,3,-3,277,343,66,19.2,80.8
6,1,1,3,-2,348,511,163,31.9,68.1
6,1,1,3,-1,339,709,370,52.2,47.8
6,1,1,3,0,264,843,579,68.7,31.3
6,1,1,3,1,166,919,753,81.9,18.1
6,1,1,3,2,73,655,582,88.9,11.1
6,1,1,3,3,32,549,517,94.2,5.80000000000001
6,1,1,3,4,7,415,408,98.3,1.7
6,1,1,3,5,7,291,284,97.6,2.40000000000001
6,1,1,3,6,3,178,175,98.3,1.7
6,1,1,3,7,0,97,97,100,0
6,1,1,3,8,0,58,58,100,0
6,1,1,3,9,0,39,39,100,0
6,1,1,3,10,0,24,24,100,0
6,1,1,3,11,0,13,13,100,0
6,1,1,3,12,0,5,5,100,0
6,1,1,3,13,0,4,4,100,0
6,1,1,3,14,0,3,3,100,0
6,1,1,3,15,0,2,2,100,0
6,1,1,13,-19,1,1,0,0,100
6,1,1,13,-16,1,1,0,0,100
6,1,1,13,-15,2,2,0,0,100
6,1,1,13,-14,2,2,0,0,100
6,1,1,13,-13,2,2,0,0,100
6,1,1,13,-12,5,5,0,0,100
6,1,1,13,-11,13,13,0,0,100
6,1,1,13,-10,22,22,0,0,100
6,1,1,13,-9,35,35,0,0,100
6,1,1,13,-8,43,43,0,0,100
6,1,1,13,-7,60,60,0,0,100
6,1,1,13,-6,110,114,4,3.5,96.5
6,1,1,13,-5,156,165,9,5.5,94.5
6,1,1,13,-4,256,294,38,12.9,87.1
6,1,1,13,-3,287,391,104,26.6,73.4
6,1,1,13,-2,361,587,226,38.5,61.5
6,1,1,13,-1,372,781,409,52.4,47.6
6,1,1,13,0,308,987,679,68.8,31.2
6,1,1,13,1,152,901,749,83.1,16.9
6,1,1,13,2,65,724,659,91,9
6,1,1,13,3,31,587,556,94.7,5.30000000000001
6,1,1,13,4,6,407,401,98.5,1.5
6,1,1,13,5,4,296,292,98.6,1.40000000000001
6,1,1,13,6,1,235,234,99.6,0.400000000000006
6,1,1,13,7,2,127,125,98.4,1.59999999999999
6,1,1,13,8,0,79,79,100,0
6,1,1,13,9,0,44,44,100,0
6,1,1,13,10,0,36,36,100,0
6,1,1,13,11,0,19,19,100,0
6,1,1,13,12,0,11,11,100,0
6,1,1,13,13,0,3,3,100,0
6,1,1,13,14,0,3,3,100,0
6,1,1,13,15,0,2,2,100,0
6,1,1,13,16,0,2,2,100,0
6,1,1,13,17,0,1,1,100,0
6,1,1,23,-16,2,2,0,0,100
6,1,1,23,-15,3,3,0,0,100
6,1,1,23,-13,1,1,0,0,100
6,1,1,23,-12,5,5,0,0,100
6,1,1,23,-11,6,6,0,0,100
6,1,1,23,-10,9,9,0,0,100
6,1,1,23,-9,21,21,0,0,100
6,1,1,23,-8,36,37,1,2.7,97.3
6,1,1,23,-7,49,50,1,2,98
6,1,1,23,-6,81,84,3,3.6,96.4
6,1,1,23,-5,117,125,8,6.4,93.6
6,1,1,23,-4,160,192,32,16.7,83.3
6,1,1,23,-3,202,300,98,32.7,67.3
6,1,1,23,-2,314,507,193,38.1,61.9
6,1,1,23,-1,259,621,362,58.3,41.7
6,1,1,23,0,188,660,472,71.5,28.5
6,1,1,23,1,111,703,592,84.2,15.8
6,1,1,23,2,55,586,531,90.6,9.39999999999999
6,1,1,23,3,27,480,453,94.4,5.60000000000001
6,1,1,23,4,9,366,357,97.5,2.5
6,1,1,23,5,2,250,248,99.2,0.799999999999997
6,1,1,23,6,2,174,172,98.9,1.09999999999999
6,1,1,23,7,0,95,95,100,0
6,1,1,23,8,0,58,58,100,0
6,1,1,23,9,1,49,48,98,2
6,1,1,23,10,0,26,26,100,0
6,1,1,23,11,0,19,19,100,0
6,1,1,23,12,0,10,10,100,0
6,1,1,23,13,0,4,4,100,0
6,1,1,23,14,0,2,2,100,0
6,1,1,23,15,0,4,4,100,0
6,1,1,23,18,0,1,1,100,0
6,1,1,123,-16,2,2,0,0,100
6,1,1,123,-15,1,1,0,0,100
6,1,1,123,-14,1,1,0,0,100
6,1,1,123,-13,4,4,0,0,100
6,1,1,123,-12,5,5,0,0,100
6,1,1,123,-11,4,4,0,0,100
6,1,1,123,-10,6,6,0,0,100
6,1,1,123,-9,8,8,0,0,100
6,1,1,123,-8,33,33,0,0,100
6,1,1,123,-7,41,42,1,2.4,97.6
6,1,1,123,-6,89,98,9,9.2,90.8
6,1,1,123,-5,108,128,20,15.6,84.4
6,1,1,123,-4,169,205,36,17.6,82.4
6,1,1,123,-3,210,298,88,29.5,70.5
6,1,1,123,-2,232,419,187,44.6,55.4
6,1,1,123,-1,258,615,357,58,42
6,1,1,123,0,245,867,622,71.7,28.3
6,1,1,123,1,123,826,703,85.1,14.9
6,1,1,123,2,49,720,671,93.2,6.8
6,1,1,123,3,24,536,512,95.5,4.5
6,1,1,123,4,6,370,364,98.4,1.59999999999999
6,1,1,123,5,4,258,254,98.4,1.59999999999999
6,1,1,123,6,0,202,202,100,0
6,1,1,123,7,0,127,127,100,0
6,1,1,123,8,0,75,75,100,0
6,1,1,123,9,0,47,47,100,0
6,1,1,123,10,0,23,23,100,0
6,1,1,123,11,0,16,16,100,0
6,1,1,123,12,0,19,19,100,0
6,1,1,123,13,0,6,6,100,0
6,1,1,123,14,0,7,7,100,0
6,1,1,123,18,0,1,1,100,0
6,1,2,0,-20,2,2,0,0,100
6,1,2,0,-19,1,1,0,0,100
6,1,2,0,-18,2,2,0,0,100
6,1,2,0,-17,2,2,0,0,100
6,1,2,0,-16,6,6,0,0,100
6,1,2,0,-15,12,12,0,0,100
6,1,2,0,-14,27,27,0,0,100
6,1,2,0,-13,50,50,0,0,100
6,1,2,0,-12,76,77,1,1.3,98.7
6,1,2,0,-11,122,122,0,0,100
6,1,2,0,-10,232,232,0,0,100
6,1,2,0,-9,367,368,1,0.3,99.7
6,1,2,0,-8,624,628,4,0.6,99.4
6,1,2,0,-7,973,982,9,0.9,99.1
6,1,2,0,-6,1544,1569,25,1.6,98.4
6,1,2,0,-5,2421,2498,77,3.1,96.9
6,1,2,0,-4,3439,3633,194,5.3,94.7
6,1,2,0,-3,4733,5263,530,10.1,89.9
6,1,2,0,-2,5743,7083,1340,18.9,81.1
6,1,2,0,-1,6210,9008,2798,31.1,68.9
6,1,2,0,0,5019,10503,5484,52.2,47.8
6,1,2,0,1,2553,9209,6656,72.3,27.7
6,1,2,0,2,1095,7205,6110,84.8,15.2
6,1,2,0,3,446,5450,5004,91.8,8.2
6,1,2,0,4,170,3868,3698,95.6,4.40000000000001
6,1,2,0,5,73,2605,2532,97.2,2.8
6,1,2,0,6,17,1712,1695,99,1
6,1,2,0,7,5,1095,1090,99.5,0.5
6,1,2,0,8,2,658,656,99.7,0.299999999999997
6,1,2,0,9,0,402,402,100,0
6,1,2,0,10,0,251,251,100,0
6,1,2,0,11,0,169,169,100,0
6,1,2,0,12,0,96,96,100,0
6,1,2,0,13,0,50,50,100,0
6,1,2,0,14,0,25,25,100,0
6,1,2,0,15,0,12,12,100,0
6,1,2,0,16,0,10,10,100,0
6,1,2,0,17,0,4,4,100,0
6,1,2,0,18,0,3,3,100,0
6,1,2,0,21,0,1,1,100,0
6,1,2,1,-21,1,1,0,0,100
6,1,2,1,-18,3,3,0,0,100
6,1,2,1,-17,5,5,0,0,100
6,1,2,1,-16,2,2,0,0,100
6,1,2,1,-15,7,7,0,0,100
6,1,2,1,-14,14,14,0,0,100
6,1,2,1,-13,35,35,0,0,100
6,1,2,1,-12,36,36,0,0,100
6,1,2,1,-11,81,81,0,0,100
6,1,2,1,-10,128,128,0,0,100
6,1,2,1,-9,191,191,0,0,100
6,1,2,1,-8,348,349,1,0.3,99.7
6,1,2,1,-7,513,519,6,1.2,98.8
6,1,2,1,-6,851,867,16,1.8,98.2
6,1,2,1,-5,1280,1335,55,4.1,95.9
6,1,2,1,-4,1825,1961,136,6.9,93.1
6,1,2,1,-3,2487,2839,352,12.4,87.6
6,1,2,1,-2,3031,3873,842,21.7,78.3
6,1,2,1,-1,3123,4700,1577,33.6,66.4
6,1,2,1,0,2462,5384,2922,54.3,45.7
6,1,2,1,1,1267,4858,3591,73.9,26.1
6,1,2,1,2,558,3882,3324,85.6,14.4
6,1,2,1,3,248,2922,2674,91.5,8.5
6,1,2,1,4,91,2208,2117,95.9,4.10000000000001
6,1,2,1,5,45,1569,1524,97.1,2.90000000000001
6,1,2,1,6,8,1045,1037,99.2,0.799999999999997
6,1,2,1,7,5,735,730,99.3,0.700000000000003
6,1,2,1,8,3,496,493,99.4,0.599999999999994
6,1,2,1,9,0,287,287,100,0
6,1,2,1,10,1,183,182,99.5,0.5
6,1,2,1,11,0,102,102,100,0
6,1,2,1,12,0,56,56,100,0
6,1,2,1,13,0,32,32,100,0
6,1,2,1,14,0,16,16,100,0
6,1,2,1,15,0,10,10,100,0
6,1,2,1,16,0,2,2,100,0
6,1,2,1,17,0,5,5,100,0
6,1,2,1,18,0,1,1,100,0
6,1,2,1,19,0,1,1,100,0
6,1,2,2,-19,1,1,0,0,100
6,1,2,2,-18,1,1,0,0,100
6,1,2,2,-16,1,1,0,0,100
6,1,2,2,-15,1,1,0,0,100
6,1,2,2,-14,4,4,0,0,100
6,1,2,2,-13,10,10,0,0,100
6,1,2,2,-12,17,17,0,0,100
6,1,2,2,-11,33,33,0,0,100
6,1,2,2,-10,56,56,0,0,100
6,1,2,2,-9,84,85,1,1.2,98.8
6,1,2,2,-8,141,143,2,1.4,98.6
6,1,2,2,-7,204,207,3,1.4,98.6
6,1,2,2,-6,351,354,3,0.8,99.2
6,1,2,2,-5,516,538,22,4.1,95.9
6,1,2,2,-4,777,837,60,7.2,92.8
6,1,2,2,-3,1057,1198,141,11.8,88.2
6,1,2,2,-2,1319,1732,413,23.8,76.2
6,1,2,2,-1,1584,2477,893,36.1,63.9
6,1,2,2,0,1284,2969,1685,56.8,43.2
6,1,2,2,1,697,2769,2072,74.8,25.2
6,1,2,2,2,364,2505,2141,85.5,14.5
6,1,2,2,3,143,2001,1858,92.9,7.09999999999999
6,1,2,2,4,53,1409,1356,96.2,3.8
6,1,2,2,5,18,1043,1025,98.3,1.7
6,1,2,2,6,3,601,598,99.5,0.5
6,1,2,2,7,0,394,394,100,0
6,1,2,2,8,0,278,278,100,0
6,1,2,2,9,0,175,175,100,0
6,1,2,2,10,0,97,97,100,0
6,1,2,2,11,0,60,60,100,0
6,1,2,2,12,0,29,29,100,0
6,1,2,2,13,0,13,13,100,0
6,1,2,2,14,0,9,9,100,0
6,1,2,2,15,0,4,4,100,0
6,1,2,2,16,0,4,4,100,0
6,1,2,2,19,0,2,2,100,0
6,1,2,2,20,0,2,2,100,0
6,1,2,12,-16,3,3,0,0,100
6,1,2,12,-15,1,1,0,0,100
6,1,2,12,-14,2,2,0,0,100
6,1,2,12,-13,11,11,0,0,100
6,1,2,12,-12,21,21,0,0,100
6,1,2,12,-11,40,40,0,0,100
6,1,2,12,-10,51,51,0,0,100
6,1,2,12,-9,63,63,0,0,100
6,1,2,12,-8,116,116,0,0,100
6,1,2,12,-7,217,223,6,2.7,97.3
6,1,2,12,-6,349,358,9,2.5,97.5
6,1,2,12,-5,542,577,35,6.1,93.9
6,1,2,12,-4,765,839,74,8.8,91.2
6,1,2,12,-3,992,1147,155,13.5,86.5
6,1,2,12,-2,1221,1666,445,26.7,73.3
6,1,2,12,-1,1283,2080,797,38.3,61.7
6,1,2,12,0,1098,2614,1516,58,42
6,1,2,12,1,597,2465,1868,75.8,24.2
6,1,2,12,2,307,2083,1776,85.3,14.7
6,1,2,12,3,121,1625,1504,92.6,7.39999999999999
6,1,2,12,4,44,1172,1128,96.2,3.8
6,1,2,12,5,17,839,822,98,2
6,1,2,12,6,5,577,572,99.1,0.900000000000006
6,1,2,12,7,3,393,390,99.2,0.799999999999997
6,1,2,12,8,2,254,252,99.2,0.799999999999997
6,1,2,12,9,1,152,151,99.3,0.700000000000003
6,1,2,12,10,0,107,107,100,0
6,1,2,12,11,0,58,58,100,0
6,1,2,12,12,0,34,34,100,0
6,1,2,12,13,0,23,23,100,0
6,1,2,12,14,0,10,10,100,0
6,1,2,12,15,0,6,6,100,0
6,1,2,12,16,0,2,2,100,0
6,1,2,12,17,0,5,5,100,0
6,1,2,12,20,0,1,1,100,0
6,1,2,3,-19,1,1,0,0,100
6,1,2,3,-18,1,1,0,0,100
6,1,2,3,-17,1,1,0,0,100
6,1,2,3,-14,1,1,0,0,100
6,1,2,3,-13,2,2,0,0,100
6,1,2,3,-12,10,10,0,0,100
6,1,2,3,-11,12,12,0,0,100
6,1,2,3,-10,12,12,0,0,100
6,1,2,3,-9,27,27,0,0,100
6,1,2,3,-8,52,52,0,0,100
6,1,2,3,-7,87,89,2,2.2,97.8
6,1,2,3,-6,126,128,2,1.6,98.4
6,1,2,3,-5,219,225,6,2.7,97.3
6,1,2,3,-4,333,355,22,6.2,93.8
6,1,2,3,-3,414,472,58,12.3,87.7
6,1,2,3,-2,537,697,160,23,77
6,1,2,3,-1,627,1015,388,38.2,61.8
6,1,2,3,0,523,1192,669,56.1,43.9
6,1,2,3,1,274,1131,857,75.8,24.2
6,1,2,3,2,129,906,777,85.8,14.2
6,1,2,3,3,58,766,708,92.4,7.59999999999999
6,1,2,3,4,17,592,575,97.1,2.90000000000001
6,1,2,3,5,15,413,398,96.4,3.60000000000001
6,1,2,3,6,3,266,263,98.9,1.09999999999999
6,1,2,3,7,1,147,146,99.3,0.700000000000003
6,1,2,3,8,1,123,122,99.2,0.799999999999997
6,1,2,3,9,0,66,66,100,0
6,1,2,3,10,1,45,44,97.8,2.2
6,1,2,3,11,0,22,22,100,0
6,1,2,3,12,0,19,19,100,0
6,1,2,3,13,0,5,5,100,0
6,1,2,3,14,0,3,3,100,0
6,1,2,3,15,0,3,3,100,0
6,1,2,3,16,0,2,2,100,0
6,1,2,13,-15,1,1,0,0,100
6,1,2,13,-14,3,3,0,0,100
6,1,2,13,-13,3,3,0,0,100
6,1,2,13,-12,9,9,0,0,100
6,1,2,13,-11,12,12,0,0,100
6,1,2,13,-10,28,28,0,0,100
6,1,2,13,-9,31,31,0,0,100
6,1,2,13,-8,40,40,0,0,100
6,1,2,13,-7,79,80,1,1.2,98.8
6,1,2,13,-6,167,171,4,2.3,97.7
6,1,2,13,-5,256,267,11,4.1,95.9
6,1,2,13,-4,372,396,24,6.1,93.9
6,1,2,13,-3,410,479,69,14.4,85.6
6,1,2,13,-2,514,706,192,27.2,72.8
6,1,2,13,-1,552,938,386,41.2,58.8
6,1,2,13,0,482,1189,707,59.5,40.5
6,1,2,13,1,269,1193,924,77.5,22.5
6,1,2,13,2,123,1053,930,88.3,11.7
6,1,2,13,3,57,807,750,92.9,7.09999999999999
6,1,2,13,4,17,573,556,97,3
6,1,2,13,5,12,466,454,97.4,2.60000000000001
6,1,2,13,6,6,334,328,98.2,1.8
6,1,2,13,7,4,190,186,97.9,2.10000000000001
6,1,2,13,8,0,122,122,100,0
6,1,2,13,9,0,70,70,100,0
6,1,2,13,10,0,54,54,100,0
6,1,2,13,11,0,22,22,100,0
6,1,2,13,12,0,21,21,100,0
6,1,2,13,13,0,7,7,100,0
6,1,2,13,14,0,5,5,100,0
6,1,2,13,15,0,2,2,100,0
6,1,2,13,16,0,5,5,100,0
6,1,2,13,19,0,1,1,100,0
6,1,2,23,-16,1,1,0,0,100
6,1,2,23,-15,1,1,0,0,100
6,1,2,23,-14,1,1,0,0,100
6,1,2,23,-13,4,4,0,0,100
6,1,2,23,-12,2,2,0,0,100
6,1,2,23,-11,4,4,0,0,100
6,1,2,23,-10,12,12,0,0,100
6,1,2,23,-9,21,21,0,0,100
6,1,2,23,-8,42,42,0,0,100
6,1,2,23,-7,59,60,1,1.7,98.3
6,1,2,23,-6,77,78,1,1.3,98.7
6,1,2,23,-5,142,148,6,4.1,95.9
6,1,2,23,-4,195,211,16,7.6,92.4
6,1,2,23,-3,247,304,57,18.8,81.2
6,1,2,23,-2,340,469,129,27.5,72.5
6,1,2,23,-1,318,568,250,44,56
6,1,2,23,0,238,640,402,62.8,37.2
6,1,2,23,1,152,684,532,77.8,22.2
6,1,2,23,2,81,641,560,87.4,12.6
6,1,2,23,3,39,525,486,92.6,7.39999999999999
6,1,2,23,4,15,414,399,96.4,3.60000000000001
6,1,2,23,5,3,296,293,99,1
6,1,2,23,6,4,212,208,98.1,1.90000000000001
6,1,2,23,7,0,107,107,100,0
6,1,2,23,8,0,63,63,100,0
6,1,2,23,9,0,59,59,100,0
6,1,2,23,10,0,30,30,100,0
6,1,2,23,11,0,22,22,100,0
6,1,2,23,12,0,12,12,100,0
6,1,2,23,13,0,7,7,100,0
6,1,2,23,14,0,4,4,100,0
6,1,2,23,15,0,3,3,100,0
6,1,2,23,17,0,1,1,100,0
6,1,2,123,-15,1,1,0,0,100
6,1,2,123,-14,1,1,0,0,100
6,1,2,123,-13,3,3,0,0,100
6,1,2,123,-12,2,2,0,0,100
6,1,2,123,-11,8,8,0,0,100
6,1,2,123,-10,11,11,0,0,100
6,1,2,123,-9,15,15,0,0,100
6,1,2,123,-8,27,27,0,0,100
6,1,2,123,-7,52,53,1,1.9,98.1
6,1,2,123,-6,85,87,2,2.3,97.7
6,1,2,123,-5,146,156,10,6.4,93.6
6,1,2,123,-4,182,206,24,11.7,88.3
6,1,2,123,-3,249,306,57,18.6,81.4
6,1,2,123,-2,346,501,155,30.9,69.1
6,1,2,123,-1,394,728,334,45.9,54.1
6,1,2,123,0,410,1047,637,60.8,39.2
6,1,2,123,1,197,904,707,78.2,21.8
6,1,2,123,2,100,843,743,88.1,11.9
6,1,2,123,3,37,632,595,94.1,5.90000000000001
6,1,2,123,4,17,462,445,96.3,3.7
6,1,2,123,5,9,344,335,97.4,2.60000000000001
6,1,2,123,6,2,241,239,99.2,0.799999999999997
6,1,2,123,7,0,140,140,100,0
6,1,2,123,8,0,114,114,100,0
6,1,2,123,9,0,57,57,100,0
6,1,2,123,10,0,41,41,100,0
6,1,2,123,11,0,26,26,100,0
6,1,2,123,12,0,16,16,100,0
6,1,2,123,13,0,8,8,100,0
6,1,2,123,14,0,5,5,100,0
6,1,2,123,16,0,2,2,100,0
6,1,2,123,17,0,1,1,100,0
7,0,0,0,-21,2,2,0,0,100
7,0,0,0,-20,2,2,0,0,100
7,0,0,0,-19,3,3,0,0,100
7,0,0,0,-18,4,4,0,0,100
7,0,0,0,-17,7,7,0,0,100
7,0,0,0,-16,11,11,0,0,100
7,0,0,0,-15,24,24,0,0,100
7,0,0,0,-14,39,39,0,0,100
7,0,0,0,-13,82,82,0,0,100
7,0,0,0,-12,136,137,1,0.7,99.3
7,0,0,0,-11,234,234,0,0,100
7,0,0,0,-10,382,382,0,0,100
7,0,0,0,-9,612,612,0,0,100
7,0,0,0,-8,1068,1071,3,0.3,99.7
7,0,0,0,-7,1674,1688,14,0.8,99.2
7,0,0,0,-6,2702,2737,35,1.3,98.7
7,0,0,0,-5,4163,4280,117,2.7,97.3
7,0,0,0,-4,5983,6276,293,4.7,95.3
7,0,0,0,-3,8118,8945,827,9.2,90.8
7,0,0,0,-2,10067,12205,2138,17.5,82.5
7,0,0,0,-1,10923,15503,4580,29.5,70.5
7,0,0,0,0,8833,17832,8999,50.5,49.5
7,0,0,0,1,4617,16238,11621,71.6,28.4
7,0,0,0,2,2115,13333,11218,84.1,15.9
7,0,0,0,3,900,10371,9471,91.3,8.7
7,0,0,0,4,339,7441,7102,95.4,4.60000000000001
7,0,0,0,5,148,5271,5123,97.2,2.8
7,0,0,0,6,38,3479,3441,98.9,1.09999999999999
7,0,0,0,7,15,2236,2221,99.3,0.700000000000003
7,0,0,0,8,5,1477,1472,99.7,0.299999999999997
7,0,0,0,9,1,902,901,99.9,0.0999999999999943
7,0,0,0,10,2,583,581,99.7,0.299999999999997
7,0,0,0,11,0,356,356,100,0
7,0,0,0,12,0,198,198,100,0
7,0,0,0,13,0,109,109,100,0
7,0,0,0,14,0,60,60,100,0
7,0,0,0,15,0,29,29,100,0
7,0,0,0,16,0,19,19,100,0
7,0,0,0,17,0,11,11,100,0
7,0,0,0,18,0,5,5,100,0
7,0,0,0,19,0,3,3,100,0
7,0,0,0,20,0,2,2,100,0
7,0,0,0,21,0,1,1,100,0
7,0,0,1,-21,1,1,0,0,100
7,0,0,1,-20,1,1,0,0,100
7,0,0,1,-19,2,2,0,0,100
7,0,0,1,-18,1,1,0,0,100
7,0,0,1,-17,2,2,0,0,100
7,0,0,1,-16,4,4,0,0,100
7,0,0,1,-15,5,5,0,0,100
7,0,0,1,-14,6,6,0,0,100
7,0,0,1,-13,17,17,0,0,100
7,0,0,1,-12,25,25,0,0,100
7,0,0,1,-11,72,72,0,0,100
7,0,0,1,-10,108,108,0,0,100
7,0,0,1,-9,163,163,0,0,100
7,0,0,1,-8,288,288,0,0,100
7,0,0,1,-7,453,457,4,0.9,99.1
7,0,0,1,-6,729,740,11,1.5,98.5
7,0,0,1,-5,1125,1145,20,1.7,98.3
7,0,0,1,-4,1604,1664,60,3.6,96.4
7,0,0,1,-3,2198,2372,174,7.3,92.7
7,0,0,1,-2,2638,3112,474,15.2,84.8
7,0,0,1,-1,2845,3835,990,25.8,74.2
7,0,0,1,0,2520,4562,2042,44.8,55.2
7,0,0,1,1,1396,4145,2749,66.3,33.7
7,0,0,1,2,720,3367,2647,78.6,21.4
7,0,0,1,3,363,2679,2316,86.5,13.5
7,0,0,1,4,118,1870,1752,93.7,6.3
7,0,0,1,5,71,1332,1261,94.7,5.30000000000001
7,0,0,1,6,18,889,871,98,2
7,0,0,1,7,8,543,535,98.5,1.5
7,0,0,1,8,2,363,361,99.4,0.599999999999994
7,0,0,1,9,1,214,213,99.5,0.5
7,0,0,1,10,1,129,128,99.2,0.799999999999997
7,0,0,1,11,0,102,102,100,0
7,0,0,1,12,0,40,40,100,0
7,0,0,1,13,0,24,24,100,0
7,0,0,1,14,0,16,16,100,0
7,0,0,1,15,0,7,7,100,0
7,0,0,1,16,0,6,6,100,0
7,0,0,1,17,0,3,3,100,0
7,0,0,1,18,0,2,2,100,0
7,0,0,1,20,0,1,1,100,0
7,0,0,2,-19,1,1,0,0,100
7,0,0,2,-16,2,2,0,0,100
7,0,0,2,-15,2,2,0,0,100
7,0,0,2,-14,1,1,0,0,100
7,0,0,2,-13,5,5,0,0,100
7,0,0,2,-12,9,9,0,0,100
7,0,0,2,-11,23,23,0,0,100
7,0,0,2,-10,39,39,0,0,100
7,0,0,2,-9,46,46,0,0,100
7,0,0,2,-8,83,83,0,0,100
7,0,0,2,-7,136,137,1,0.7,99.3
7,0,0,2,-6,208,209,1,0.5,99.5
7,0,0,2,-5,347,355,8,2.3,97.7
7,0,0,2,-4,546,558,12,2.2,97.8
7,0,0,2,-3,666,716,50,7,93
7,0,0,2,-2,821,955,134,14,86
7,0,0,2,-1,812,1086,274,25.2,74.8
7,0,0,2,0,732,1200,468,39,61
7,0,0,2,1,429,1046,617,59,41
7,0,0,2,2,195,786,591,75.2,24.8
7,0,0,2,3,95,628,533,84.9,15.1
7,0,0,2,4,35,428,393,91.8,8.2
7,0,0,2,5,24,306,282,92.2,7.8
7,0,0,2,6,6,212,206,97.2,2.8
7,0,0,2,7,0,138,138,100,0
7,0,0,2,8,0,77,77,100,0
7,0,0,2,9,0,64,64,100,0
7,0,0,2,10,0,47,47,100,0
7,0,0,2,11,0,25,25,100,0
7,0,0,2,12,0,10,10,100,0
7,0,0,2,13,0,3,3,100,0
7,0,0,2,14,0,3,3,100,0
7,0,0,2,15,0,2,2,100,0
7,0,0,2,16,0,2,2,100,0
7,0,0,2,17,0,1,1,100,0
7,0,0,12,-21,1,1,0,0,100
7,0,0,12,-16,2,2,0,0,100
7,0,0,12,-15,2,2,0,0,100
7,0,0,12,-14,3,3,0,0,100
7,0,0,12,-13,8,8,0,0,100
7,0,0,12,-12,7,7,0,0,100
7,0,0,12,-11,25,25,0,0,100
7,0,0,12,-10,29,29,0,0,100
7,0,0,12,-9,47,47,0,0,100
7,0,0,12,-8,88,88,0,0,100
7,0,0,12,-7,130,130,0,0,100
7,0,0,12,-6,228,230,2,0.9,99.1
7,0,0,12,-5,300,302,2,0.7,99.3
7,0,0,12,-4,402,416,14,3.4,96.6
7,0,0,12,-3,513,554,41,7.4,92.6
7,0,0,12,-2,581,656,75,11.4,88.6
7,0,0,12,-1,587,755,168,22.3,77.7
7,0,0,12,0,564,859,295,34.3,65.7
7,0,0,12,1,399,860,461,53.6,46.4
7,0,0,12,2,271,840,569,67.7,32.3
7,0,0,12,3,138,687,549,79.9,20.1
7,0,0,12,4,47,517,470,90.9,9.09999999999999
7,0,0,12,5,31,355,324,91.3,8.7
7,0,0,12,6,7,211,204,96.7,3.3
7,0,0,12,7,2,146,144,98.6,1.40000000000001
7,0,0,12,8,1,77,76,98.7,1.3
7,0,0,12,9,0,53,53,100,0
7,0,0,12,10,1,33,32,97,3
7,0,0,12,11,0,21,21,100,0
7,0,0,12,12,0,9,9,100,0
7,0,0,12,13,0,9,9,100,0
7,0,0,12,14,0,5,5,100,0
7,0,0,12,15,0,1,1,100,0
7,0,0,12,16,0,1,1,100,0
7,0,0,12,17,0,1,1,100,0
7,0,0,12,18,0,1,1,100,0
7,0,0,3,-18,1,1,0,0,100
7,0,0,3,-14,1,1,0,0,100
7,0,0,3,-13,2,2,0,0,100
7,0,0,3,-12,1,1,0,0,100
7,0,0,3,-11,1,1,0,0,100
7,0,0,3,-10,8,8,0,0,100
7,0,0,3,-9,10,10,0,0,100
7,0,0,3,-8,15,15,0,0,100
7,0,0,3,-7,29,29,0,0,100
7,0,0,3,-6,36,38,2,5.3,94.7
7,0,0,3,-5,92,94,2,2.1,97.9
7,0,0,3,-4,116,122,6,4.9,95.1
7,0,0,3,-3,133,143,10,7,93
7,0,0,3,-2,149,177,28,15.8,84.2
7,0,0,3,-1,182,221,39,17.6,82.4
7,0,0,3,0,118,182,64,35.2,64.8
7,0,0,3,1,63,153,90,58.8,41.2
7,0,0,3,2,37,119,82,68.9,31.1
7,0,0,3,3,13,83,70,84.3,15.7
7,0,0,3,4,8,68,60,88.2,11.8
7,0,0,3,5,2,43,41,95.3,4.7
7,0,0,3,6,1,31,30,96.8,3.2
7,0,0,3,7,0,19,19,100,0
7,0,0,3,8,1,16,15,93.8,6.2
7,0,0,3,9,0,7,7,100,0
7,0,0,3,10,0,7,7,100,0
7,0,0,3,11,0,3,3,100,0
7,0,0,3,12,0,1,1,100,0
7,0,0,13,-21,1,1,0,0,100
7,0,0,13,-13,3,3,0,0,100
7,0,0,13,-12,6,6,0,0,100
7,0,0,13,-11,7,7,0,0,100
7,0,0,13,-10,8,8,0,0,100
7,0,0,13,-9,16,16,0,0,100
7,0,0,13,-8,22,22,0,0,100
7,0,0,13,-7,51,51,0,0,100
7,0,0,13,-6,80,81,1,1.2,98.8
7,0,0,13,-5,111,113,2,1.8,98.2
7,0,0,13,-4,162,164,2,1.2,98.8
7,0,0,13,-3,241,255,14,5.5,94.5
7,0,0,13,-2,288,316,28,8.9,91.1
7,0,0,13,-1,314,350,36,10.3,89.7
7,0,0,13,0,236,340,104,30.6,69.4
7,0,0,13,1,196,380,184,48.4,51.6
7,0,0,13,2,92,278,186,66.9,33.1
7,0,0,13,3,40,213,173,81.2,18.8
7,0,0,13,4,22,129,107,82.9,17.1
7,0,0,13,5,10,106,96,90.6,9.39999999999999
7,0,0,13,6,3,50,47,94,6
7,0,0,13,7,1,40,39,97.5,2.5
7,0,0,13,8,0,17,17,100,0
7,0,0,13,9,0,14,14,100,0
7,0,0,13,10,0,8,8,100,0
7,0,0,13,11,0,9,9,100,0
7,0,0,13,12,0,4,4,100,0
7,0,0,13,13,0,1,1,100,0
7,0,0,13,14,0,2,2,100,0
7,0,0,23,-16,2,2,0,0,100
7,0,0,23,-15,2,2,0,0,100
7,0,0,23,-13,3,3,0,0,100
7,0,0,23,-12,3,3,0,0,100
7,0,0,23,-11,4,4,0,0,100
7,0,0,23,-10,7,7,0,0,100
7,0,0,23,-9,10,10,0,0,100
7,0,0,23,-8,28,28,0,0,100
7,0,0,23,-7,30,30,0,0,100
7,0,0,23,-6,61,61,0,0,100
7,0,0,23,-5,80,81,1,1.2,98.8
7,0,0,23,-4,92,95,3,3.2,96.8
7,0,0,23,-3,142,148,6,4.1,95.9
7,0,0,23,-2,136,149,13,8.7,91.3
7,0,0,23,-1,167,199,32,16.1,83.9
7,0,0,23,0,140,200,60,30,70
7,0,0,23,1,100,191,91,47.6,52.4
7,0,0,23,2,70,174,104,59.8,40.2
7,0,0,23,3,28,142,114,80.3,19.7
7,0,0,23,4,16,99,83,83.8,16.2
7,0,0,23,5,4,76,72,94.7,5.30000000000001
7,0,0,23,6,1,39,38,97.4,2.60000000000001
7,0,0,23,7,1,23,22,95.7,4.3
7,0,0,23,8,1,18,17,94.4,5.60000000000001
7,0,0,23,9,0,11,11,100,0
7,0,0,23,10,0,6,6,100,0
7,0,0,23,11,0,4,4,100,0
7,0,0,23,12,0,1,1,100,0
7,0,0,23,14,0,1,1,100,0
7,0,0,23,17,0,1,1,100,0
7,0,0,123,-16,1,1,0,0,100
7,0,0,123,-15,1,1,0,0,100
7,0,0,123,-13,3,3,0,0,100
7,0,0,123,-12,2,2,0,0,100
7,0,0,123,-11,6,6,0,0,100
7,0,0,123,-10,11,11,0,0,100
7,0,0,123,-9,12,12,0,0,100
7,0,0,123,-8,23,23,0,0,100
7,0,0,123,-7,33,33,0,0,100
7,0,0,123,-6,64,65,1,1.5,98.5
7,0,0,123,-5,73,74,1,1.4,98.6
7,0,0,123,-4,118,118,0,0,100
7,0,0,123,-3,134,142,8,5.6,94.4
7,0,0,123,-2,169,181,12,6.6,93.4
7,0,0,123,-1,199,233,34,14.6,85.4
7,0,0,123,0,156,205,49,23.9,76.1
7,0,0,123,1,137,222,85,38.3,61.7
7,0,0,123,2,90,205,115,56.1,43.9
7,0,0,123,3,47,159,112,70.4,29.6
7,0,0,123,4,13,100,87,87,13
7,0,0,123,5,6,74,68,91.9,8.09999999999999
7,0,0,123,6,4,51,47,92.2,7.8
7,0,0,123,7,0,36,36,100,0
7,0,0,123,8,1,14,13,92.9,7.09999999999999
7,0,0,123,9,0,11,11,100,0
7,0,0,123,10,1,14,13,92.9,7.09999999999999
7,0,0,123,11,0,11,11,100,0
7,0,0,123,13,0,1,1,100,0
7,0,0,123,14,0,3,3,100,0
7,0,0,123,18,0,1,1,100,0
7,0,1,0,-21,2,2,0,0,100
7,0,1,0,-20,2,2,0,0,100
7,0,1,0,-19,1,1,0,0,100
7,0,1,0,-18,3,3,0,0,100
7,0,1,0,-17,6,6,0,0,100
7,0,1,0,-16,9,9,0,0,100
7,0,1,0,-15,22,22,0,0,100
7,0,1,0,-14,34,34,0,0,100
7,0,1,0,-13,72,72,0,0,100
7,0,1,0,-12,123,124,1,0.8,99.2
7,0,1,0,-11,181,181,0,0,100
7,0,1,0,-10,285,285,0,0,100
7,0,1,0,-9,458,458,0,0,100
7,0,1,0,-8,821,825,4,0.5,99.5
7,0,1,0,-7,1277,1289,12,0.9,99.1
7,0,1,0,-6,1997,2022,25,1.2,98.8
7,0,1,0,-5,3056,3161,105,3.3,96.7
7,0,1,0,-4,4358,4604,246,5.3,94.7
7,0,1,0,-3,5846,6515,669,10.3,89.7
7,0,1,0,-2,7247,8921,1674,18.8,81.2
7,0,1,0,-1,7657,11252,3595,31.9,68.1
7,0,1,0,0,5748,12567,6819,54.3,45.7
7,0,1,0,1,2824,11442,8618,75.3,24.7
7,0,1,0,2,1195,9346,8151,87.2,12.8
7,0,1,0,3,422,7106,6684,94.1,5.90000000000001
7,0,1,0,4,170,5140,4970,96.7,3.3
7,0,1,0,5,53,3653,3600,98.5,1.5
7,0,1,0,6,13,2367,2354,99.5,0.5
7,0,1,0,7,8,1568,1560,99.5,0.5
7,0,1,0,8,2,1032,1030,99.8,0.200000000000003
7,0,1,0,9,0,621,621,100,0
7,0,1,0,10,1,395,394,99.7,0.299999999999997
7,0,1,0,11,0,231,231,100,0
7,0,1,0,12,0,142,142,100,0
7,0,1,0,13,0,80,80,100,0
7,0,1,0,14,0,45,45,100,0
7,0,1,0,15,0,18,18,100,0
7,0,1,0,16,0,10,10,100,0
7,0,1,0,17,0,7,7,100,0
7,0,1,0,18,0,3,3,100,0
7,0,1,0,19,0,3,3,100,0
7,0,1,0,20,0,1,1,100,0
7,0,1,0,21,0,1,1,100,0
7,0,1,1,-22,1,1,0,0,100
7,0,1,1,-20,1,1,0,0,100
7,0,1,1,-19,2,2,0,0,100
7,0,1,1,-18,2,2,0,0,100
7,0,1,1,-17,5,5,0,0,100
7,0,1,1,-16,3,3,0,0,100
7,0,1,1,-15,10,10,0,0,100
7,0,1,1,-14,14,14,0,0,100
7,0,1,1,-13,40,40,0,0,100
7,0,1,1,-12,64,65,1,1.5,98.5
7,0,1,1,-11,81,81,0,0,100
7,0,1,1,-10,138,138,0,0,100
7,0,1,1,-9,227,227,0,0,100
7,0,1,1,-8,379,379,0,0,100
7,0,1,1,-7,623,626,3,0.5,99.5
7,0,1,1,-6,942,955,13,1.4,98.6
7,0,1,1,-5,1349,1384,35,2.5,97.5
7,0,1,1,-4,1886,1973,87,4.4,95.6
7,0,1,1,-3,2534,2790,256,9.2,90.8
7,0,1,1,-2,2954,3590,636,17.7,82.3
7,0,1,1,-1,3088,4399,1311,29.8,70.2
7,0,1,1,0,2615,5126,2511,49,51
7,0,1,1,1,1315,4627,3312,71.6,28.4
7,0,1,1,2,641,3960,3319,83.8,16.2
7,0,1,1,3,295,3025,2730,90.2,9.8
7,0,1,1,4,100,2193,2093,95.4,4.60000000000001
7,0,1,1,5,42,1558,1516,97.3,2.7
7,0,1,1,6,11,1007,996,98.9,1.09999999999999
7,0,1,1,7,3,655,652,99.5,0.5
7,0,1,1,8,2,462,460,99.6,0.400000000000006
7,0,1,1,9,0,282,282,100,0
7,0,1,1,10,0,171,171,100,0
7,0,1,1,11,0,105,105,100,0
7,0,1,1,12,0,48,48,100,0
7,0,1,1,13,0,36,36,100,0
7,0,1,1,14,0,15,15,100,0
7,0,1,1,15,0,6,6,100,0
7,0,1,1,16,0,5,5,100,0
7,0,1,1,17,0,3,3,100,0
7,0,1,1,18,0,1,1,100,0
7,0,1,1,19,0,1,1,100,0
7,0,1,1,20,0,1,1,100,0
7,0,1,1,21,0,1,1,100,0
7,0,1,2,-19,1,1,0,0,100
7,0,1,2,-17,5,5,0,0,100
7,0,1,2,-16,4,4,0,0,100
7,0,1,2,-15,3,3,0,0,100
7,0,1,2,-14,5,5,0,0,100
7,0,1,2,-13,8,8,0,0,100
7,0,1,2,-12,21,21,0,0,100
7,0,1,2,-11,42,42,0,0,100
7,0,1,2,-10,60,60,0,0,100
7,0,1,2,-9,97,97,0,0,100
7,0,1,2,-8,170,170,0,0,100
7,0,1,2,-7,225,226,1,0.4,99.6
7,0,1,2,-6,428,429,1,0.2,99.8
7,0,1,2,-5,645,664,19,2.9,97.1
7,0,1,2,-4,1075,1118,43,3.8,96.2
7,0,1,2,-3,1379,1488,109,7.3,92.7
7,0,1,2,-2,1681,2020,339,16.8,83.2
7,0,1,2,-1,1786,2442,656,26.9,73.1
7,0,1,2,0,1401,2646,1245,47.1,52.9
7,0,1,2,1,667,2065,1398,67.7,32.3
7,0,1,2,2,233,1296,1063,82,18
7,0,1,2,3,90,953,863,90.6,9.39999999999999
7,0,1,2,4,52,672,620,92.3,7.69999999999999
7,0,1,2,5,13,503,490,97.4,2.60000000000001
7,0,1,2,6,1,323,322,99.7,0.299999999999997
7,0,1,2,7,0,195,195,100,0
7,0,1,2,8,0,134,134,100,0
7,0,1,2,9,0,72,72,100,0
7,0,1,2,10,0,55,55,100,0
7,0,1,2,11,0,29,29,100,0
7,0,1,2,12,0,17,17,100,0
7,0,1,2,13,0,9,9,100,0
7,0,1,2,14,0,5,5,100,0
7,0,1,2,15,0,5,5,100,0
7,0,1,2,16,0,1,1,100,0
7,0,1,2,17,0,2,2,100,0
7,0,1,2,18,0,1,1,100,0
7,0,1,12,-22,1,1,0,0,100
7,0,1,12,-18,1,1,0,0,100
7,0,1,12,-17,2,2,0,0,100
7,0,1,12,-16,4,4,0,0,100
7,0,1,12,-15,5,5,0,0,100
7,0,1,12,-14,7,7,0,0,100
7,0,1,12,-13,16,16,0,0,100
7,0,1,12,-12,26,26,0,0,100
7,0,1,12,-11,44,44,0,0,100
7,0,1,12,-10,68,68,0,0,100
7,0,1,12,-9,111,111,0,0,100
7,0,1,12,-8,195,195,0,0,100
7,0,1,12,-7,267,267,0,0,100
7,0,1,12,-6,421,425,4,0.9,99.1
7,0,1,12,-5,560,577,17,2.9,97.1
7,0,1,12,-4,793,825,32,3.9,96.1
7,0,1,12,-3,1029,1122,93,8.3,91.7
7,0,1,12,-2,1144,1359,215,15.8,84.2
7,0,1,12,-1,1187,1587,400,25.2,74.8
7,0,1,12,0,957,1764,807,45.7,54.3
7,0,1,12,1,581,1516,935,61.7,38.3
7,0,1,12,2,303,1347,1044,77.5,22.5
7,0,1,12,3,144,1058,914,86.4,13.6
7,0,1,12,4,51,764,713,93.3,6.69999999999999
7,0,1,12,5,25,525,500,95.2,4.80000000000001
7,0,1,12,6,5,362,357,98.6,1.40000000000001
7,0,1,12,7,3,236,233,98.7,1.3
7,0,1,12,8,1,162,161,99.4,0.599999999999994
7,0,1,12,9,0,89,89,100,0
7,0,1,12,10,0,53,53,100,0
7,0,1,12,11,0,32,32,100,0
7,0,1,12,12,0,15,15,100,0
7,0,1,12,13,0,17,17,100,0
7,0,1,12,14,0,3,3,100,0
7,0,1,12,15,0,1,1,100,0
7,0,1,12,16,0,3,3,100,0
7,0,1,12,17,0,3,3,100,0
7,0,1,12,18,0,1,1,100,0
7,0,1,12,19,0,1,1,100,0
7,0,1,3,-15,1,1,0,0,100
7,0,1,3,-14,3,3,0,0,100
7,0,1,3,-13,6,6,0,0,100
7,0,1,3,-12,7,7,0,0,100
7,0,1,3,-11,12,12,0,0,100
7,0,1,3,-10,23,23,0,0,100
7,0,1,3,-9,37,37,0,0,100
7,0,1,3,-8,59,60,1,1.7,98.3
7,0,1,3,-7,80,80,0,0,100
7,0,1,3,-6,133,133,0,0,100
7,0,1,3,-5,270,274,4,1.5,98.5
7,0,1,3,-4,382,394,12,3,97
7,0,1,3,-3,488,526,38,7.2,92.8
7,0,1,3,-2,558,658,100,15.2,84.8
7,0,1,3,-1,557,745,188,25.2,74.8
7,0,1,3,0,469,775,306,39.5,60.5
7,0,1,3,1,225,644,419,65.1,34.9
7,0,1,3,2,77,405,328,81,19
7,0,1,3,3,36,274,238,86.9,13.1
7,0,1,3,4,7,199,192,96.5,3.5
7,0,1,3,5,8,147,139,94.6,5.40000000000001
7,0,1,3,6,1,68,67,98.5,1.5
7,0,1,3,7,0,46,46,100,0
7,0,1,3,8,0,36,36,100,0
7,0,1,3,9,0,30,30,100,0
7,0,1,3,10,0,16,16,100,0
7,0,1,3,11,0,9,9,100,0
7,0,1,3,12,0,5,5,100,0
7,0,1,3,13,0,1,1,100,0
7,0,1,3,16,0,1,1,100,0
7,0,1,13,-19,1,1,0,0,100
7,0,1,13,-17,1,1,0,0,100
7,0,1,13,-15,1,1,0,0,100
7,0,1,13,-13,9,9,0,0,100
7,0,1,13,-12,5,5,0,0,100
7,0,1,13,-11,13,13,0,0,100
7,0,1,13,-10,22,22,0,0,100
7,0,1,13,-9,46,46,0,0,100
7,0,1,13,-8,80,80,0,0,100
7,0,1,13,-7,127,127,0,0,100
7,0,1,13,-6,189,189,0,0,100
7,0,1,13,-5,298,305,7,2.3,97.7
7,0,1,13,-4,404,420,16,3.8,96.2
7,0,1,13,-3,512,547,35,6.4,93.6
7,0,1,13,-2,589,687,98,14.3,85.7
7,0,1,13,-1,618,786,168,21.4,78.6
7,0,1,13,0,570,904,334,36.9,63.1
7,0,1,13,1,293,741,448,60.5,39.5
7,0,1,13,2,150,572,422,73.8,26.2
7,0,1,13,3,69,445,376,84.5,15.5
7,0,1,13,4,29,286,257,89.9,10.1
7,0,1,13,5,16,221,205,92.8,7.19999999999999
7,0,1,13,6,1,129,128,99.2,0.799999999999997
7,0,1,13,7,0,67,67,100,0
7,0,1,13,8,0,41,41,100,0
7,0,1,13,9,0,29,29,100,0
7,0,1,13,10,0,26,26,100,0
7,0,1,13,11,0,18,18,100,0
7,0,1,13,12,0,10,10,100,0
7,0,1,13,13,0,6,6,100,0
7,0,1,13,14,0,3,3,100,0
7,0,1,13,15,0,1,1,100,0
7,0,1,13,17,0,1,1,100,0
7,0,1,23,-16,1,1,0,0,100
7,0,1,23,-15,2,2,0,0,100
7,0,1,23,-14,3,3,0,0,100
7,0,1,23,-13,7,7,0,0,100
7,0,1,23,-12,5,5,0,0,100
7,0,1,23,-11,20,20,0,0,100
7,0,1,23,-10,25,25,0,0,100
7,0,1,23,-9,30,30,0,0,100
7,0,1,23,-8,49,49,0,0,100
7,0,1,23,-7,87,87,0,0,100
7,0,1,23,-6,152,153,1,0.7,99.3
7,0,1,23,-5,220,227,7,3.1,96.9
7,0,1,23,-4,316,327,11,3.4,96.6
7,0,1,23,-3,434,461,27,5.9,94.1
7,0,1,23,-2,424,488,64,13.1,86.9
7,0,1,23,-1,516,648,132,20.4,79.6
7,0,1,23,0,459,670,211,31.5,68.5
7,0,1,23,1,267,601,334,55.6,44.4
7,0,1,23,2,131,413,282,68.3,31.7
7,0,1,23,3,34,264,230,87.1,12.9
7,0,1,23,4,16,200,184,92,8
7,0,1,23,5,3,135,132,97.8,2.2
7,0,1,23,6,3,84,81,96.4,3.60000000000001
7,0,1,23,7,0,49,49,100,0
7,0,1,23,8,0,34,34,100,0
7,0,1,23,9,0,21,21,100,0
7,0,1,23,10,0,12,12,100,0
7,0,1,23,11,0,8,8,100,0
7,0,1,23,12,0,7,7,100,0
7,0,1,23,13,0,4,4,100,0
7,0,1,23,14,0,3,3,100,0
7,0,1,23,17,0,1,1,100,0
7,0,1,123,-17,1,1,0,0,100
7,0,1,123,-16,2,2,0,0,100
7,0,1,123,-14,2,2,0,0,100
7,0,1,123,-13,9,9,0,0,100
7,0,1,123,-12,8,8,0,0,100
7,0,1,123,-11,20,20,0,0,100
7,0,1,123,-10,22,22,0,0,100
7,0,1,123,-9,42,42,0,0,100
7,0,1,123,-8,60,60,0,0,100
7,0,1,123,-7,96,96,0,0,100
7,0,1,123,-6,188,191,3,1.6,98.4
7,0,1,123,-5,243,245,2,0.8,99.2
7,0,1,123,-4,341,351,10,2.8,97.2
7,0,1,123,-3,454,497,43,8.7,91.3
7,0,1,123,-2,517,576,59,10.2,89.8
7,0,1,123,-1,534,674,140,20.8,79.2
7,0,1,123,0,480,752,272,36.2,63.8
7,0,1,123,1,287,605,318,52.6,47.4
7,0,1,123,2,131,386,255,66.1,33.9
7,0,1,123,3,72,300,228,76,24
7,0,1,123,4,27,190,163,85.8,14.2
7,0,1,123,5,7,130,123,94.6,5.40000000000001
7,0,1,123,6,2,99,97,98,2
7,0,1,123,7,1,66,65,98.5,1.5
7,0,1,123,8,1,42,41,97.6,2.40000000000001
7,0,1,123,9,0,21,21,100,0
7,0,1,123,10,0,9,9,100,0
7,0,1,123,11,0,5,5,100,0
7,0,1,123,12,0,2,2,100,0
7,0,1,123,13,0,1,1,100,0
7,0,1,123,14,0,2,2,100,0
7,0,1,123,18,0,1,1,100,0
7,0,2,0,-21,2,2,0,0,100
7,0,2,0,-20,2,2,0,0,100
7,0,2,0,-19,1,1,0,0,100
7,0,2,0,-18,4,4,0,0,100
7,0,2,0,-17,2,2,0,0,100
7,0,2,0,-16,8,8,0,0,100
7,0,2,0,-15,29,29,0,0,100
7,0,2,0,-14,31,31,0,0,100
7,0,2,0,-13,53,53,0,0,100
7,0,2,0,-12,106,106,0,0,100
7,0,2,0,-11,168,168,0,0,100
7,0,2,0,-10,262,262,0,0,100
7,0,2,0,-9,419,419,0,0,100
7,0,2,0,-8,742,746,4,0.5,99.5
7,0,2,0,-7,1099,1111,12,1.1,98.9
7,0,2,0,-6,1683,1707,24,1.4,98.6
7,0,2,0,-5,2614,2713,99,3.6,96.4
7,0,2,0,-4,3615,3825,210,5.5,94.5
7,0,2,0,-3,4744,5312,568,10.7,89.3
7,0,2,0,-2,5706,7113,1407,19.8,80.2
7,0,2,0,-1,5876,8855,2979,33.6,66.4
7,0,2,0,0,4139,9675,5536,57.2,42.8
7,0,2,0,1,1889,8848,6959,78.7,21.3
7,0,2,0,2,771,7234,6463,89.3,10.7
7,0,2,0,3,261,5493,5232,95.2,4.80000000000001
7,0,2,0,4,102,3927,3825,97.4,2.60000000000001
7,0,2,0,5,33,2674,2641,98.8,1.2
7,0,2,0,6,10,1799,1789,99.4,0.599999999999994
7,0,2,0,7,8,1193,1185,99.3,0.700000000000003
7,0,2,0,8,0,761,761,100,0
7,0,2,0,9,0,453,453,100,0
7,0,2,0,10,1,293,292,99.7,0.299999999999997
7,0,2,0,11,0,176,176,100,0
7,0,2,0,12,0,108,108,100,0
7,0,2,0,13,0,54,54,100,0
7,0,2,0,14,0,34,34,100,0
7,0,2,0,15,0,13,13,100,0
7,0,2,0,16,0,10,10,100,0
7,0,2,0,17,0,5,5,100,0
7,0,2,0,18,0,2,2,100,0
7,0,2,0,19,0,2,2,100,0
7,0,2,1,-20,1,1,0,0,100
7,0,2,1,-19,2,2,0,0,100
7,0,2,1,-18,1,1,0,0,100
7,0,2,1,-17,3,3,0,0,100
7,0,2,1,-16,6,6,0,0,100
7,0,2,1,-15,17,17,0,0,100
7,0,2,1,-14,34,34,0,0,100
7,0,2,1,-13,43,43,0,0,100
7,0,2,1,-12,67,68,1,1.5,98.5
7,0,2,1,-11,107,107,0,0,100
7,0,2,1,-10,177,177,0,0,100
7,0,2,1,-9,279,280,1,0.4,99.6
7,0,2,1,-8,443,443,0,0,100
7,0,2,1,-7,727,736,9,1.2,98.8
7,0,2,1,-6,1089,1099,10,0.9,99.1
7,0,2,1,-5,1494,1537,43,2.8,97.2
7,0,2,1,-4,2018,2124,106,5,95
7,0,2,1,-3,2578,2884,306,10.6,89.4
7,0,2,1,-2,3000,3675,675,18.4,81.6
7,0,2,1,-1,3002,4466,1464,32.8,67.2
7,0,2,1,0,2300,5010,2710,54.1,45.9
7,0,2,1,1,1134,4632,3498,75.5,24.5
7,0,2,1,2,478,3927,3449,87.8,12.2
7,0,2,1,3,203,2926,2723,93.1,6.89999999999999
7,0,2,1,4,64,2152,2088,97,3
7,0,2,1,5,27,1467,1440,98.2,1.8
7,0,2,1,6,10,1004,994,99,1
7,0,2,1,7,1,643,642,99.8,0.200000000000003
7,0,2,1,8,0,434,434,100,0
7,0,2,1,9,0,276,276,100,0
7,0,2,1,10,0,139,139,100,0
7,0,2,1,11,0,89,89,100,0
7,0,2,1,12,0,61,61,100,0
7,0,2,1,13,0,37,37,100,0
7,0,2,1,14,0,22,22,100,0
7,0,2,1,15,0,5,5,100,0
7,0,2,1,16,0,10,10,100,0
7,0,2,1,17,0,3,3,100,0
7,0,2,1,18,0,1,1,100,0
7,0,2,1,21,0,1,1,100,0
7,0,2,2,-20,1,1,0,0,100
7,0,2,2,-17,3,3,0,0,100
7,0,2,2,-16,5,5,0,0,100
7,0,2,2,-15,6,6,0,0,100
7,0,2,2,-14,13,13,0,0,100
7,0,2,2,-13,15,15,0,0,100
7,0,2,2,-12,31,31,0,0,100
7,0,2,2,-11,52,52,0,0,100
7,0,2,2,-10,107,107,0,0,100
7,0,2,2,-9,150,150,0,0,100
7,0,2,2,-8,240,240,0,0,100
7,0,2,2,-7,350,350,0,0,100
7,0,2,2,-6,605,611,6,1,99
7,0,2,2,-5,875,900,25,2.8,97.2
7,0,2,2,-4,1277,1348,71,5.3,94.7
7,0,2,2,-3,1645,1828,183,10,90
7,0,2,2,-2,2010,2477,467,18.9,81.1
7,0,2,2,-1,1951,2801,850,30.3,69.7
7,0,2,2,0,1398,2953,1555,52.7,47.3
7,0,2,2,1,586,2351,1765,75.1,24.9
7,0,2,2,2,232,1567,1335,85.2,14.8
7,0,2,2,3,78,1207,1129,93.5,6.5
7,0,2,2,4,41,853,812,95.2,4.80000000000001
7,0,2,2,5,15,624,609,97.6,2.40000000000001
7,0,2,2,6,1,373,372,99.7,0.299999999999997
7,0,2,2,7,2,250,248,99.2,0.799999999999997
7,0,2,2,8,1,138,137,99.3,0.700000000000003
7,0,2,2,9,0,84,84,100,0
7,0,2,2,10,0,69,69,100,0
7,0,2,2,11,0,50,50,100,0
7,0,2,2,12,0,23,23,100,0
7,0,2,2,13,0,9,9,100,0
7,0,2,2,14,0,6,6,100,0
7,0,2,2,15,0,5,5,100,0
7,0,2,2,16,0,2,2,100,0
7,0,2,2,17,0,1,1,100,0
7,0,2,12,-22,2,2,0,0,100
7,0,2,12,-21,1,1,0,0,100
7,0,2,12,-20,1,1,0,0,100
7,0,2,12,-19,1,1,0,0,100
7,0,2,12,-17,2,2,0,0,100
7,0,2,12,-16,7,7,0,0,100
7,0,2,12,-15,9,9,0,0,100
7,0,2,12,-14,22,22,0,0,100
7,0,2,12,-13,22,22,0,0,100
7,0,2,12,-12,42,42,0,0,100
7,0,2,12,-11,66,66,0,0,100
7,0,2,12,-10,106,106,0,0,100
7,0,2,12,-9,173,173,0,0,100
7,0,2,12,-8,215,215,0,0,100
7,0,2,12,-7,369,371,2,0.5,99.5
7,0,2,12,-6,559,568,9,1.6,98.4
7,0,2,12,-5,831,853,22,2.6,97.4
7,0,2,12,-4,1078,1142,64,5.6,94.4
7,0,2,12,-3,1418,1575,157,10,90
7,0,2,12,-2,1559,1907,348,18.2,81.8
7,0,2,12,-1,1609,2316,707,30.5,69.5
7,0,2,12,0,1213,2423,1210,49.9,50.1
7,0,2,12,1,510,1953,1443,73.9,26.1
7,0,2,12,2,228,1616,1388,85.9,14.1
7,0,2,12,3,101,1211,1110,91.7,8.3
7,0,2,12,4,34,885,851,96.2,3.8
7,0,2,12,5,16,601,585,97.3,2.7
7,0,2,12,6,4,389,385,99,1
7,0,2,12,7,2,255,253,99.2,0.799999999999997
7,0,2,12,8,0,180,180,100,0
7,0,2,12,9,0,107,107,100,0
7,0,2,12,10,0,50,50,100,0
7,0,2,12,11,0,27,27,100,0
7,0,2,12,12,0,23,23,100,0
7,0,2,12,13,0,16,16,100,0
7,0,2,12,14,0,9,9,100,0
7,0,2,12,15,0,2,2,100,0
7,0,2,12,16,0,4,4,100,0
7,0,2,12,17,0,4,4,100,0
7,0,2,12,18,0,1,1,100,0
7,0,2,12,19,0,1,1,100,0
7,0,2,3,-17,3,3,0,0,100
7,0,2,3,-15,3,3,0,0,100
7,0,2,3,-14,4,4,0,0,100
7,0,2,3,-13,10,10,0,0,100
7,0,2,3,-12,26,26,0,0,100
7,0,2,3,-11,24,24,0,0,100
7,0,2,3,-10,43,43,0,0,100
7,0,2,3,-9,66,66,0,0,100
7,0,2,3,-8,120,121,1,0.8,99.2
7,0,2,3,-7,145,146,1,0.7,99.3
7,0,2,3,-6,247,252,5,2,98
7,0,2,3,-5,383,389,6,1.5,98.5
7,0,2,3,-4,562,587,25,4.3,95.7
7,0,2,3,-3,590,648,58,9,91
7,0,2,3,-2,790,968,178,18.4,81.6
7,0,2,3,-1,732,1072,340,31.7,68.3
7,0,2,3,0,522,1087,565,52,48
7,0,2,3,1,232,934,702,75.2,24.8
7,0,2,3,2,80,632,552,87.3,12.7
7,0,2,3,3,28,439,411,93.6,6.39999999999999
7,0,2,3,4,9,329,320,97.3,2.7
7,0,2,3,5,5,227,222,97.8,2.2
7,0,2,3,6,2,149,147,98.7,1.3
7,0,2,3,7,1,68,67,98.5,1.5
7,0,2,3,8,0,50,50,100,0
7,0,2,3,9,1,34,33,97.1,2.90000000000001
7,0,2,3,10,0,33,33,100,0
7,0,2,3,11,0,9,9,100,0
7,0,2,3,12,0,4,4,100,0
7,0,2,3,13,0,6,6,100,0
7,0,2,3,14,0,1,1,100,0
7,0,2,3,16,0,4,4,100,0
7,0,2,13,-24,1,1,0,0,100
7,0,2,13,-23,1,1,0,0,100
7,0,2,13,-19,1,1,0,0,100
7,0,2,13,-16,2,2,0,0,100
7,0,2,13,-15,1,1,0,0,100
7,0,2,13,-14,6,6,0,0,100
7,0,2,13,-13,11,11,0,0,100
7,0,2,13,-12,14,14,0,0,100
7,0,2,13,-11,33,33,0,0,100
7,0,2,13,-10,48,48,0,0,100
7,0,2,13,-9,74,74,0,0,100
7,0,2,13,-8,133,133,0,0,100
7,0,2,13,-7,171,172,1,0.6,99.4
7,0,2,13,-6,313,313,0,0,100
7,0,2,13,-5,418,428,10,2.3,97.7
7,0,2,13,-4,542,576,34,5.9,94.1
7,0,2,13,-3,688,763,75,9.8,90.2
7,0,2,13,-2,760,942,182,19.3,80.7
7,0,2,13,-1,811,1080,269,24.9,75.1
7,0,2,13,0,556,1100,544,49.5,50.5
7,0,2,13,1,292,965,673,69.7,30.3
7,0,2,13,2,122,684,562,82.2,17.8
7,0,2,13,3,39,491,452,92.1,7.89999999999999
7,0,2,13,4,21,360,339,94.2,5.80000000000001
7,0,2,13,5,11,250,239,95.6,4.40000000000001
7,0,2,13,6,2,166,164,98.8,1.2
7,0,2,13,7,0,85,85,100,0
7,0,2,13,8,0,76,76,100,0
7,0,2,13,9,0,42,42,100,0
7,0,2,13,10,0,24,24,100,0
7,0,2,13,11,0,17,17,100,0
7,0,2,13,12,0,7,7,100,0
7,0,2,13,13,0,5,5,100,0
7,0,2,13,16,0,3,3,100,0
7,0,2,13,17,0,1,1,100,0
7,0,2,23,-18,1,1,0,0,100
7,0,2,23,-17,1,1,0,0,100
7,0,2,23,-16,3,3,0,0,100
7,0,2,23,-15,6,6,0,0,100
7,0,2,23,-14,4,4,0,0,100
7,0,2,23,-13,7,7,0,0,100
7,0,2,23,-12,13,13,0,0,100
7,0,2,23,-11,19,19,0,0,100
7,0,2,23,-10,29,29,0,0,100
7,0,2,23,-9,38,38,0,0,100
7,0,2,23,-8,79,79,0,0,100
7,0,2,23,-7,110,111,1,0.9,99.1
7,0,2,23,-6,162,165,3,1.8,98.2
7,0,2,23,-5,246,258,12,4.7,95.3
7,0,2,23,-4,368,387,19,4.9,95.1
7,0,2,23,-3,394,432,38,8.8,91.2
7,0,2,23,-2,470,572,102,17.8,82.2
7,0,2,23,-1,449,622,173,27.8,72.2
7,0,2,23,0,325,641,316,49.3,50.7
7,0,2,23,1,150,521,371,71.2,28.8
7,0,2,23,2,79,401,322,80.3,19.7
7,0,2,23,3,26,311,285,91.6,8.39999999999999
7,0,2,23,4,12,233,221,94.8,5.2
7,0,2,23,5,6,161,155,96.3,3.7
7,0,2,23,6,2,101,99,98,2
7,0,2,23,7,1,68,67,98.5,1.5
7,0,2,23,8,0,35,35,100,0
7,0,2,23,9,0,27,27,100,0
7,0,2,23,10,0,12,12,100,0
7,0,2,23,11,0,10,10,100,0
7,0,2,23,12,0,4,4,100,0
7,0,2,23,13,0,5,5,100,0
7,0,2,23,16,0,1,1,100,0
7,0,2,123,-17,3,3,0,0,100
7,0,2,123,-16,4,4,0,0,100
7,0,2,123,-15,3,3,0,0,100
7,0,2,123,-14,10,10,0,0,100
7,0,2,123,-13,6,6,0,0,100
7,0,2,123,-12,14,14,0,0,100
7,0,2,123,-11,30,30,0,0,100
7,0,2,123,-10,29,29,0,0,100
7,0,2,123,-9,59,59,0,0,100
7,0,2,123,-8,81,81,0,0,100
7,0,2,123,-7,127,128,1,0.8,99.2
7,0,2,123,-6,225,231,6,2.6,97.4
7,0,2,123,-5,347,358,11,3.1,96.9
7,0,2,123,-4,420,436,16,3.7,96.3
7,0,2,123,-3,555,605,50,8.3,91.7
7,0,2,123,-2,598,709,111,15.7,84.3
7,0,2,123,-1,619,836,217,26,74
7,0,2,123,0,468,889,421,47.4,52.6
7,0,2,123,1,204,647,443,68.5,31.5
7,0,2,123,2,106,479,373,77.9,22.1
7,0,2,123,3,45,357,312,87.4,12.6
7,0,2,123,4,24,279,255,91.4,8.59999999999999
7,0,2,123,5,12,152,140,92.1,7.89999999999999
7,0,2,123,6,2,103,101,98.1,1.90000000000001
7,0,2,123,7,0,67,67,100,0
7,0,2,123,8,0,36,36,100,0
7,0,2,123,9,0,28,28,100,0
7,0,2,123,10,0,11,11,100,0
7,0,2,123,11,0,6,6,100,0
7,0,2,123,12,0,6,6,100,0
7,0,2,123,14,0,1,1,100,0
7,0,2,123,15,0,1,1,100,0
7,0,2,123,16,0,2,2,100,0
7,0,2,123,17,0,1,1,100,0
7,0,2,123,19,0,1,1,100,0
7,1,0,0,-24,1,1,0,0,100
7,1,0,0,-22,1,1,0,0,100
7,1,0,0,-21,2,2,0,0,100
7,1,0,0,-20,2,2,0,0,100
7,1,0,0,-19,6,6,0,0,100
7,1,0,0,-18,6,6,0,0,100
7,1,0,0,-17,15,15,0,0,100
7,1,0,0,-16,23,23,0,0,100
7,1,0,0,-15,43,43,0,0,100
7,1,0,0,-14,73,73,0,0,100
7,1,0,0,-13,112,112,0,0,100
7,1,0,0,-12,236,237,1,0.4,99.6
7,1,0,0,-11,343,344,1,0.3,99.7
7,1,0,0,-10,571,571,0,0,100
7,1,0,0,-9,870,871,1,0.1,99.9
7,1,0,0,-8,1486,1490,4,0.3,99.7
7,1,0,0,-7,2286,2309,23,1,99
7,1,0,0,-6,3491,3541,50,1.4,98.6
7,1,0,0,-5,5089,5276,187,3.5,96.5
7,1,0,0,-4,6844,7255,411,5.7,94.3
7,1,0,0,-3,8745,9851,1106,11.2,88.8
7,1,0,0,-2,10198,12882,2684,20.8,79.2
7,1,0,0,-1,10161,15559,5398,34.7,65.3
7,1,0,0,0,6906,16863,9957,59,41
7,1,0,0,1,2860,15112,12252,81.1,18.9
7,1,0,0,2,1132,12314,11182,90.8,9.2
7,1,0,0,3,411,9260,8849,95.6,4.40000000000001
7,1,0,0,4,156,6724,6568,97.7,2.3
7,1,0,0,5,43,4718,4675,99.1,0.900000000000006
7,1,0,0,6,13,3134,3121,99.6,0.400000000000006
7,1,0,0,7,4,2013,2009,99.8,0.200000000000003
7,1,0,0,8,1,1339,1338,99.9,0.0999999999999943
7,1,0,0,9,0,826,826,100,0
7,1,0,0,10,1,528,527,99.8,0.200000000000003
7,1,0,0,11,0,324,324,100,0
7,1,0,0,12,0,181,181,100,0
7,1,0,0,13,0,96,96,100,0
7,1,0,0,14,0,54,54,100,0
7,1,0,0,15,0,26,26,100,0
7,1,0,0,16,0,23,23,100,0
7,1,0,0,17,0,8,8,100,0
7,1,0,0,18,0,4,4,100,0
7,1,0,0,19,0,3,3,100,0
7,1,0,0,20,0,1,1,100,0
7,1,0,0,21,0,2,2,100,0
7,1,0,1,-21,1,1,0,0,100
7,1,0,1,-19,2,2,0,0,100
7,1,0,1,-18,3,3,0,0,100
7,1,0,1,-17,3,3,0,0,100
7,1,0,1,-16,7,7,0,0,100
7,1,0,1,-15,12,12,0,0,100
7,1,0,1,-14,24,24,0,0,100
7,1,0,1,-13,26,26,0,0,100
7,1,0,1,-12,66,66,0,0,100
7,1,0,1,-11,78,78,0,0,100
7,1,0,1,-10,132,132,0,0,100
7,1,0,1,-9,210,211,1,0.5,99.5
7,1,0,1,-8,383,384,1,0.3,99.7
7,1,0,1,-7,603,615,12,2,98
7,1,0,1,-6,877,896,19,2.1,97.9
7,1,0,1,-5,1275,1346,71,5.3,94.7
7,1,0,1,-4,1714,1859,145,7.8,92.2
7,1,0,1,-3,2101,2540,439,17.3,82.7
7,1,0,1,-2,2380,3320,940,28.3,71.7
7,1,0,1,-1,2385,4135,1750,42.3,57.7
7,1,0,1,0,1527,4478,2951,65.9,34.1
7,1,0,1,1,625,3985,3360,84.3,15.7
7,1,0,1,2,250,3264,3014,92.3,7.69999999999999
7,1,0,1,3,94,2500,2406,96.2,3.8
7,1,0,1,4,42,1776,1734,97.6,2.40000000000001
7,1,0,1,5,10,1227,1217,99.2,0.799999999999997
7,1,0,1,6,3,883,880,99.7,0.299999999999997
7,1,0,1,7,2,547,545,99.6,0.400000000000006
7,1,0,1,8,0,352,352,100,0
7,1,0,1,9,0,232,232,100,0
7,1,0,1,10,0,134,134,100,0
7,1,0,1,11,0,103,103,100,0
7,1,0,1,12,0,49,49,100,0
7,1,0,1,13,0,25,25,100,0
7,1,0,1,14,0,16,16,100,0
7,1,0,1,15,0,8,8,100,0
7,1,0,1,16,0,6,6,100,0
7,1,0,1,17,0,5,5,100,0
7,1,0,1,18,0,2,2,100,0
7,1,0,1,19,0,1,1,100,0
7,1,0,2,-17,1,1,0,0,100
7,1,0,2,-16,2,2,0,0,100
7,1,0,2,-15,5,5,0,0,100
7,1,0,2,-14,4,4,0,0,100
7,1,0,2,-13,6,6,0,0,100
7,1,0,2,-12,11,11,0,0,100
7,1,0,2,-11,21,21,0,0,100
7,1,0,2,-10,41,41,0,0,100
7,1,0,2,-9,54,54,0,0,100
7,1,0,2,-8,89,89,0,0,100
7,1,0,2,-7,134,136,2,1.5,98.5
7,1,0,2,-6,227,232,5,2.2,97.8
7,1,0,2,-5,306,326,20,6.1,93.9
7,1,0,2,-4,413,456,43,9.4,90.6
7,1,0,2,-3,501,616,115,18.7,81.3
7,1,0,2,-2,540,791,251,31.7,68.3
7,1,0,2,-1,474,951,477,50.2,49.8
7,1,0,2,0,322,1148,826,72,28
7,1,0,2,1,138,1074,936,87.2,12.8
7,1,0,2,2,58,927,869,93.7,6.3
7,1,0,2,3,22,730,708,97,3
7,1,0,2,4,7,636,629,98.9,1.09999999999999
7,1,0,2,5,1,417,416,99.8,0.200000000000003
7,1,0,2,6,2,278,276,99.3,0.700000000000003
7,1,0,2,7,0,183,183,100,0
7,1,0,2,8,0,127,127,100,0
7,1,0,2,9,0,72,72,100,0
7,1,0,2,10,0,44,44,100,0
7,1,0,2,11,0,21,21,100,0
7,1,0,2,12,0,17,17,100,0
7,1,0,2,13,0,4,4,100,0
7,1,0,2,14,0,2,2,100,0
7,1,0,2,15,0,3,3,100,0
7,1,0,2,18,0,1,1,100,0
7,1,0,12,-19,1,1,0,0,100
7,1,0,12,-17,1,1,0,0,100
7,1,0,12,-16,1,1,0,0,100
7,1,0,12,-15,1,1,0,0,100
7,1,0,12,-14,8,8,0,0,100
7,1,0,12,-13,7,7,0,0,100
7,1,0,12,-12,15,15,0,0,100
7,1,0,12,-11,13,13,0,0,100
7,1,0,12,-10,41,41,0,0,100
7,1,0,12,-9,55,56,1,1.8,98.2
7,1,0,12,-8,93,94,1,1.1,98.9
7,1,0,12,-7,154,159,5,3.1,96.9
7,1,0,12,-6,241,249,8,3.2,96.8
7,1,0,12,-5,324,354,30,8.5,91.5
7,1,0,12,-4,410,474,64,13.5,86.5
7,1,0,12,-3,509,689,180,26.1,73.9
7,1,0,12,-2,554,866,312,36,64
7,1,0,12,-1,354,766,412,53.8,46.2
7,1,0,12,0,198,762,564,74,26
7,1,0,12,1,90,726,636,87.6,12.4
7,1,0,12,2,36,653,617,94.5,5.5
7,1,0,12,3,15,552,537,97.3,2.7
7,1,0,12,4,11,454,443,97.6,2.40000000000001
7,1,0,12,5,2,336,334,99.4,0.599999999999994
7,1,0,12,6,1,254,253,99.6,0.400000000000006
7,1,0,12,7,1,137,136,99.3,0.700000000000003
7,1,0,12,8,0,126,126,100,0
7,1,0,12,9,0,85,85,100,0
7,1,0,12,10,0,35,35,100,0
7,1,0,12,11,0,26,26,100,0
7,1,0,12,12,0,14,14,100,0
7,1,0,12,13,0,10,10,100,0
7,1,0,12,14,0,4,4,100,0
7,1,0,12,15,0,2,2,100,0
7,1,0,12,16,0,1,1,100,0
7,1,0,12,17,0,2,2,100,0
7,1,0,12,18,0,3,3,100,0
7,1,0,3,-17,1,1,0,0,100
7,1,0,3,-13,2,2,0,0,100
7,1,0,3,-11,4,4,0,0,100
7,1,0,3,-10,5,5,0,0,100
7,1,0,3,-9,9,9,0,0,100
7,1,0,3,-8,15,15,0,0,100
7,1,0,3,-7,26,26,0,0,100
7,1,0,3,-6,36,36,0,0,100
7,1,0,3,-5,40,42,2,4.8,95.2
7,1,0,3,-4,54,63,9,14.3,85.7
7,1,0,3,-3,93,112,19,17,83
7,1,0,3,-2,100,156,56,35.9,64.1
7,1,0,3,-1,72,167,95,56.9,43.1
7,1,0,3,0,59,212,153,72.2,27.8
7,1,0,3,1,19,226,207,91.6,8.39999999999999
7,1,0,3,2,11,215,204,94.9,5.10000000000001
7,1,0,3,3,6,174,168,96.6,3.40000000000001
7,1,0,3,4,0,151,151,100,0
7,1,0,3,5,1,99,98,99,1
7,1,0,3,6,0,53,53,100,0
7,1,0,3,7,0,49,49,100,0
7,1,0,3,8,0,33,33,100,0
7,1,0,3,9,0,12,12,100,0
7,1,0,3,10,0,6,6,100,0
7,1,0,3,11,0,7,7,100,0
7,1,0,3,12,0,3,3,100,0
7,1,0,3,13,0,2,2,100,0
7,1,0,3,14,0,1,1,100,0
7,1,0,3,17,0,1,1,100,0
7,1,0,13,-17,1,1,0,0,100
7,1,0,13,-16,1,1,0,0,100
7,1,0,13,-15,1,1,0,0,100
7,1,0,13,-14,2,2,0,0,100
7,1,0,13,-13,1,1,0,0,100
7,1,0,13,-12,7,7,0,0,100
7,1,0,13,-11,8,8,0,0,100
7,1,0,13,-10,7,7,0,0,100
7,1,0,13,-9,19,19,0,0,100
7,1,0,13,-8,24,24,0,0,100
7,1,0,13,-7,38,40,2,5,95
7,1,0,13,-6,53,58,5,8.6,91.4
7,1,0,13,-5,89,101,12,11.9,88.1
7,1,0,13,-4,126,136,10,7.4,92.6
7,1,0,13,-3,146,186,40,21.5,78.5
7,1,0,13,-2,154,263,109,41.4,58.6
7,1,0,13,-1,133,320,187,58.4,41.6
7,1,0,13,0,67,357,290,81.2,18.8
7,1,0,13,1,25,360,335,93.1,6.89999999999999
7,1,0,13,2,10,328,318,97,3
7,1,0,13,3,2,240,238,99.2,0.799999999999997
7,1,0,13,4,1,227,226,99.6,0.400000000000006
7,1,0,13,5,0,112,112,100,0
7,1,0,13,6,0,76,76,100,0
7,1,0,13,7,0,86,86,100,0
7,1,0,13,8,0,53,53,100,0
7,1,0,13,9,0,25,25,100,0
7,1,0,13,10,0,13,13,100,0
7,1,0,13,11,0,10,10,100,0
7,1,0,13,12,0,3,3,100,0
7,1,0,13,13,0,1,1,100,0
7,1,0,13,15,0,2,2,100,0
7,1,0,13,17,0,1,1,100,0
7,1,0,13,18,0,1,1,100,0
7,1,0,23,-13,1,1,0,0,100
7,1,0,23,-12,4,4,0,0,100
7,1,0,23,-11,4,4,0,0,100
7,1,0,23,-10,2,2,0,0,100
7,1,0,23,-9,10,10,0,0,100
7,1,0,23,-8,19,21,2,9.5,90.5
7,1,0,23,-7,28,29,1,3.4,96.6
7,1,0,23,-6,36,38,2,5.3,94.7
7,1,0,23,-5,52,58,6,10.3,89.7
7,1,0,23,-4,75,88,13,14.8,85.2
7,1,0,23,-3,80,127,47,37,63
7,1,0,23,-2,82,179,97,54.2,45.8
7,1,0,23,-1,55,167,112,67.1,32.9
7,1,0,23,0,39,192,153,79.7,20.3
7,1,0,23,1,15,202,187,92.6,7.39999999999999
7,1,0,23,2,9,187,178,95.2,4.80000000000001
7,1,0,23,3,1,135,134,99.3,0.700000000000003
7,1,0,23,4,1,116,115,99.1,0.900000000000006
7,1,0,23,5,1,84,83,98.8,1.2
7,1,0,23,6,0,63,63,100,0
7,1,0,23,7,0,40,40,100,0
7,1,0,23,8,0,23,23,100,0
7,1,0,23,9,0,22,22,100,0
7,1,0,23,10,0,5,5,100,0
7,1,0,23,11,0,5,5,100,0
7,1,0,23,12,0,3,3,100,0
7,1,0,23,14,0,3,3,100,0
7,1,0,23,15,0,1,1,100,0
7,1,0,23,16,0,3,3,100,0
7,1,0,23,18,0,1,1,100,0
7,1,0,123,-14,1,1,0,0,100
7,1,0,123,-13,2,2,0,0,100
7,1,0,123,-12,3,3,0,0,100
7,1,0,123,-11,3,3,0,0,100
7,1,0,123,-10,12,12,0,0,100
7,1,0,123,-9,13,13,0,0,100
7,1,0,123,-8,22,22,0,0,100
7,1,0,123,-7,23,25,2,8,92
7,1,0,123,-6,46,49,3,6.1,93.9
7,1,0,123,-5,66,85,19,22.4,77.6
7,1,0,123,-4,90,108,18,16.7,83.3
7,1,0,123,-3,96,149,53,35.6,64.4
7,1,0,123,-2,93,208,115,55.3,44.7
7,1,0,123,-1,51,189,138,73,27
7,1,0,123,0,44,264,220,83.3,16.7
7,1,0,123,1,14,227,213,93.8,6.2
7,1,0,123,2,8,224,216,96.4,3.60000000000001
7,1,0,123,3,2,174,172,98.9,1.09999999999999
7,1,0,123,4,1,149,148,99.3,0.700000000000003
7,1,0,123,5,1,111,110,99.1,0.900000000000006
7,1,0,123,6,0,78,78,100,0
7,1,0,123,7,0,50,50,100,0
7,1,0,123,8,0,27,27,100,0
7,1,0,123,9,0,23,23,100,0
7,1,0,123,10,0,11,11,100,0
7,1,0,123,11,0,7,7,100,0
7,1,0,123,12,0,4,4,100,0
7,1,0,123,13,0,3,3,100,0
7,1,1,0,-24,1,1,0,0,100
7,1,1,0,-22,1,1,0,0,100
7,1,1,0,-21,1,1,0,0,100
7,1,1,0,-20,2,2,0,0,100
7,1,1,0,-19,4,4,0,0,100
7,1,1,0,-18,3,3,0,0,100
7,1,1,0,-17,11,11,0,0,100
7,1,1,0,-16,14,14,0,0,100
7,1,1,0,-15,26,26,0,0,100
7,1,1,0,-14,51,51,0,0,100
7,1,1,0,-13,78,78,0,0,100
7,1,1,0,-12,162,162,0,0,100
7,1,1,0,-11,240,241,1,0.4,99.6
7,1,1,0,-10,390,390,0,0,100
7,1,1,0,-9,603,603,0,0,100
7,1,1,0,-8,1008,1010,2,0.2,99.8
7,1,1,0,-7,1558,1569,11,0.7,99.3
7,1,1,0,-6,2373,2397,24,1,99
7,1,1,0,-5,3535,3627,92,2.5,97.5
7,1,1,0,-4,4748,4964,216,4.4,95.6
7,1,1,0,-3,6278,6814,536,7.9,92.1
7,1,1,0,-2,7468,8951,1483,16.6,83.4
7,1,1,0,-1,7618,10817,3199,29.6,70.4
7,1,1,0,0,5328,11774,6446,54.7,45.3
7,1,1,0,1,2269,10691,8422,78.8,21.2
7,1,1,0,2,911,8873,7962,89.7,10.3
7,1,1,0,3,323,6739,6416,95.2,4.80000000000001
7,1,1,0,4,121,4922,4801,97.5,2.5
7,1,1,0,5,37,3535,3498,99,1
7,1,1,0,6,10,2320,2310,99.6,0.400000000000006
7,1,1,0,7,2,1544,1542,99.9,0.0999999999999943
7,1,1,0,8,1,991,990,99.9,0.0999999999999943
7,1,1,0,9,0,617,617,100,0
7,1,1,0,10,1,403,402,99.8,0.200000000000003
7,1,1,0,11,0,233,233,100,0
7,1,1,0,12,0,136,136,100,0
7,1,1,0,13,0,81,81,100,0
7,1,1,0,14,0,46,46,100,0
7,1,1,0,15,0,21,21,100,0
7,1,1,0,16,0,18,18,100,0
7,1,1,0,17,0,5,5,100,0
7,1,1,0,18,0,3,3,100,0
7,1,1,0,19,0,2,2,100,0
7,1,1,0,20,0,2,2,100,0
7,1,1,0,21,0,2,2,100,0
7,1,1,1,-21,2,2,0,0,100
7,1,1,1,-19,1,1,0,0,100
7,1,1,1,-18,2,2,0,0,100
7,1,1,1,-17,5,5,0,0,100
7,1,1,1,-16,9,9,0,0,100
7,1,1,1,-15,12,12,0,0,100
7,1,1,1,-14,30,30,0,0,100
7,1,1,1,-13,33,33,0,0,100
7,1,1,1,-12,64,64,0,0,100
7,1,1,1,-11,109,109,0,0,100
7,1,1,1,-10,175,175,0,0,100
7,1,1,1,-9,246,246,0,0,100
7,1,1,1,-8,445,445,0,0,100
7,1,1,1,-7,702,708,6,0.8,99.2
7,1,1,1,-6,1029,1043,14,1.3,98.7
7,1,1,1,-5,1563,1625,62,3.8,96.2
7,1,1,1,-4,2075,2200,125,5.7,94.3
7,1,1,1,-3,2671,3004,333,11.1,88.9
7,1,1,1,-2,3012,3835,823,21.5,78.5
7,1,1,1,-1,2914,4480,1566,35,65
7,1,1,1,0,1919,4812,2893,60.1,39.9
7,1,1,1,1,779,4281,3502,81.8,18.2
7,1,1,1,2,326,3612,3286,91,9
7,1,1,1,3,108,2867,2759,96.2,3.8
7,1,1,1,4,56,2187,2131,97.4,2.60000000000001
7,1,1,1,5,19,1598,1579,98.8,1.2
7,1,1,1,6,5,1134,1129,99.6,0.400000000000006
7,1,1,1,7,3,707,704,99.6,0.400000000000006
7,1,1,1,8,1,475,474,99.8,0.200000000000003
7,1,1,1,9,0,327,327,100,0
7,1,1,1,10,1,191,190,99.5,0.5
7,1,1,1,11,0,129,129,100,0
7,1,1,1,12,0,78,78,100,0
7,1,1,1,13,0,31,31,100,0
7,1,1,1,14,0,24,24,100,0
7,1,1,1,15,0,14,14,100,0
7,1,1,1,16,0,11,11,100,0
7,1,1,1,17,0,3,3,100,0
7,1,1,1,18,0,2,2,100,0
7,1,1,1,20,0,1,1,100,0
7,1,1,1,21,0,1,1,100,0
7,1,1,2,-18,1,1,0,0,100
7,1,1,2,-17,1,1,0,0,100
7,1,1,2,-16,1,1,0,0,100
7,1,1,2,-15,5,5,0,0,100
7,1,1,2,-14,5,5,0,0,100
7,1,1,2,-13,11,11,0,0,100
7,1,1,2,-12,22,22,0,0,100
7,1,1,2,-11,26,26,0,0,100
7,1,1,2,-10,58,58,0,0,100
7,1,1,2,-9,77,77,0,0,100
7,1,1,2,-8,142,143,1,0.7,99.3
7,1,1,2,-7,195,196,1,0.5,99.5
7,1,1,2,-6,308,318,10,3.1,96.9
7,1,1,2,-5,476,495,19,3.8,96.2
7,1,1,2,-4,616,655,39,6,94
7,1,1,2,-3,843,944,101,10.7,89.3
7,1,1,2,-2,958,1235,277,22.4,77.6
7,1,1,2,-1,1439,2372,933,39.3,60.7
7,1,1,2,0,1048,2930,1882,64.2,35.8
7,1,1,2,1,430,2607,2177,83.5,16.5
7,1,1,2,2,152,2188,2036,93.1,6.89999999999999
7,1,1,2,3,67,1656,1589,96,4
7,1,1,2,4,23,1152,1129,98,2
7,1,1,2,5,5,744,739,99.3,0.700000000000003
7,1,1,2,6,2,457,455,99.6,0.400000000000006
7,1,1,2,7,0,287,287,100,0
7,1,1,2,8,0,217,217,100,0
7,1,1,2,9,0,119,119,100,0
7,1,1,2,10,0,78,78,100,0
7,1,1,2,11,0,61,61,100,0
7,1,1,2,12,0,36,36,100,0
7,1,1,2,13,0,14,14,100,0
7,1,1,2,14,0,12,12,100,0
7,1,1,2,15,0,4,4,100,0
7,1,1,2,16,0,3,3,100,0
7,1,1,2,17,0,2,2,100,0
7,1,1,2,18,0,2,2,100,0
7,1,1,2,19,0,1,1,100,0
7,1,1,2,20,0,1,1,100,0
7,1,1,2,21,0,1,1,100,0
7,1,1,12,-18,1,1,0,0,100
7,1,1,12,-17,3,3,0,0,100
7,1,1,12,-16,4,4,0,0,100
7,1,1,12,-15,3,3,0,0,100
7,1,1,12,-14,7,7,0,0,100
7,1,1,12,-13,10,10,0,0,100
7,1,1,12,-12,25,25,0,0,100
7,1,1,12,-11,29,29,0,0,100
7,1,1,12,-10,59,59,0,0,100
7,1,1,12,-9,96,96,0,0,100
7,1,1,12,-8,129,129,0,0,100
7,1,1,12,-7,272,277,5,1.8,98.2
7,1,1,12,-6,381,390,9,2.3,97.7
7,1,1,12,-5,526,552,26,4.7,95.3
7,1,1,12,-4,704,773,69,8.9,91.1
7,1,1,12,-3,926,1116,190,17,83
7,1,1,12,-2,978,1373,395,28.8,71.2
7,1,1,12,-1,875,1560,685,43.9,56.1
7,1,1,12,0,673,1923,1250,65,35
7,1,1,12,1,283,1784,1501,84.1,15.9
7,1,1,12,2,100,1454,1354,93.1,6.89999999999999
7,1,1,12,3,43,1213,1170,96.5,3.5
7,1,1,12,4,22,930,908,97.6,2.40000000000001
7,1,1,12,5,5,693,688,99.3,0.700000000000003
7,1,1,12,6,2,472,470,99.6,0.400000000000006
7,1,1,12,7,1,315,314,99.7,0.299999999999997
7,1,1,12,8,0,237,237,100,0
7,1,1,12,9,1,151,150,99.3,0.700000000000003
7,1,1,12,10,0,100,100,100,0
7,1,1,12,11,0,64,64,100,0
7,1,1,12,12,0,39,39,100,0
7,1,1,12,13,0,23,23,100,0
7,1,1,12,14,0,12,12,100,0
7,1,1,12,15,0,7,7,100,0
7,1,1,12,16,0,5,5,100,0
7,1,1,12,18,0,3,3,100,0
7,1,1,12,19,0,1,1,100,0
7,1,1,3,-17,1,1,0,0,100
7,1,1,3,-15,1,1,0,0,100
7,1,1,3,-14,1,1,0,0,100
7,1,1,3,-13,3,3,0,0,100
7,1,1,3,-12,6,6,0,0,100
7,1,1,3,-11,10,10,0,0,100
7,1,1,3,-10,15,15,0,0,100
7,1,1,3,-9,24,24,0,0,100
7,1,1,3,-8,37,37,0,0,100
7,1,1,3,-7,62,63,1,1.6,98.4
7,1,1,3,-6,90,91,1,1.1,98.9
7,1,1,3,-5,128,133,5,3.8,96.2
7,1,1,3,-4,202,219,17,7.8,92.2
7,1,1,3,-3,230,277,47,17,83
7,1,1,3,-2,298,412,114,27.7,72.3
7,1,1,3,-1,377,689,312,45.3,54.7
7,1,1,3,0,254,827,573,69.3,30.7
7,1,1,3,1,109,790,681,86.2,13.8
7,1,1,3,2,59,745,686,92.1,7.89999999999999
7,1,1,3,3,19,578,559,96.7,3.3
7,1,1,3,4,6,452,446,98.7,1.3
7,1,1,3,5,0,274,274,100,0
7,1,1,3,6,1,177,176,99.4,0.599999999999994
7,1,1,3,7,0,94,94,100,0
7,1,1,3,8,0,83,83,100,0
7,1,1,3,9,0,44,44,100,0
7,1,1,3,10,0,27,27,100,0
7,1,1,3,11,0,16,16,100,0
7,1,1,3,12,0,11,11,100,0
7,1,1,3,13,0,5,5,100,0
7,1,1,3,14,0,2,2,100,0
7,1,1,3,15,0,1,1,100,0
7,1,1,3,16,0,1,1,100,0
7,1,1,3,17,0,2,2,100,0
7,1,1,13,-17,2,2,0,0,100
7,1,1,13,-15,3,3,0,0,100
7,1,1,13,-14,3,3,0,0,100
7,1,1,13,-13,8,8,0,0,100
7,1,1,13,-12,8,8,0,0,100
7,1,1,13,-11,10,10,0,0,100
7,1,1,13,-10,26,26,0,0,100
7,1,1,13,-9,36,36,0,0,100
7,1,1,13,-8,68,69,1,1.4,98.6
7,1,1,13,-7,78,79,1,1.3,98.7
7,1,1,13,-6,125,129,4,3.1,96.9
7,1,1,13,-5,194,204,10,4.9,95.1
7,1,1,13,-4,267,300,33,11,89
7,1,1,13,-3,340,410,70,17.1,82.9
7,1,1,13,-2,368,532,164,30.8,69.2
7,1,1,13,-1,368,725,357,49.2,50.8
7,1,1,13,0,238,905,667,73.7,26.3
7,1,1,13,1,116,846,730,86.3,13.7
7,1,1,13,2,44,767,723,94.3,5.7
7,1,1,13,3,14,647,633,97.8,2.2
7,1,1,13,4,6,471,465,98.7,1.3
7,1,1,13,5,2,346,344,99.4,0.599999999999994
7,1,1,13,6,1,245,244,99.6,0.400000000000006
7,1,1,13,7,0,157,157,100,0
7,1,1,13,8,0,98,98,100,0
7,1,1,13,9,0,65,65,100,0
7,1,1,13,10,0,35,35,100,0
7,1,1,13,11,0,23,23,100,0
7,1,1,13,12,0,20,20,100,0
7,1,1,13,13,0,8,8,100,0
7,1,1,13,14,0,9,9,100,0
7,1,1,13,15,0,2,2,100,0
7,1,1,13,16,0,1,1,100,0
7,1,1,13,17,0,2,2,100,0
7,1,1,13,18,0,1,1,100,0
7,1,1,13,20,0,1,1,100,0
7,1,1,23,-19,1,1,0,0,100
7,1,1,23,-17,1,1,0,0,100
7,1,1,23,-16,3,3,0,0,100
7,1,1,23,-15,1,1,0,0,100
7,1,1,23,-14,5,5,0,0,100
7,1,1,23,-13,2,2,0,0,100
7,1,1,23,-12,10,10,0,0,100
7,1,1,23,-11,9,9,0,0,100
7,1,1,23,-10,11,11,0,0,100
7,1,1,23,-9,22,22,0,0,100
7,1,1,23,-8,26,26,0,0,100
7,1,1,23,-7,52,54,2,3.7,96.3
7,1,1,23,-6,79,81,2,2.5,97.5
7,1,1,23,-5,115,126,11,8.7,91.3
7,1,1,23,-4,179,200,21,10.5,89.5
7,1,1,23,-3,206,262,56,21.4,78.6
7,1,1,23,-2,327,529,202,38.2,61.8
7,1,1,23,-1,251,578,327,56.6,43.4
7,1,1,23,0,128,560,432,77.1,22.9
7,1,1,23,1,92,675,583,86.4,13.6
7,1,1,23,2,33,596,563,94.5,5.5
7,1,1,23,3,10,450,440,97.8,2.2
7,1,1,23,4,7,377,370,98.1,1.90000000000001
7,1,1,23,5,2,218,216,99.1,0.900000000000006
7,1,1,23,6,1,185,184,99.5,0.5
7,1,1,23,7,0,115,115,100,0
7,1,1,23,8,0,64,64,100,0
7,1,1,23,9,0,57,57,100,0
7,1,1,23,10,1,24,23,95.8,4.2
7,1,1,23,11,0,22,22,100,0
7,1,1,23,12,0,13,13,100,0
7,1,1,23,13,0,8,8,100,0
7,1,1,23,14,0,6,6,100,0
7,1,1,23,18,0,1,1,100,0
7,1,1,123,-16,1,1,0,0,100
7,1,1,123,-15,1,1,0,0,100
7,1,1,123,-14,1,1,0,0,100
7,1,1,123,-13,4,4,0,0,100
7,1,1,123,-12,10,10,0,0,100
7,1,1,123,-11,14,14,0,0,100
7,1,1,123,-10,11,11,0,0,100
7,1,1,123,-9,28,28,0,0,100
7,1,1,123,-8,33,34,1,2.9,97.1
7,1,1,123,-7,50,51,1,2,98
7,1,1,123,-6,88,92,4,4.3,95.7
7,1,1,123,-5,129,143,14,9.8,90.2
7,1,1,123,-4,164,201,37,18.4,81.6
7,1,1,123,-3,235,307,72,23.5,76.5
7,1,1,123,-2,242,406,164,40.4,59.6
7,1,1,123,-1,271,616,345,56,44
7,1,1,123,0,184,793,609,76.8,23.2
7,1,1,123,1,94,806,712,88.3,11.7
7,1,1,123,2,39,700,661,94.4,5.60000000000001
7,1,1,123,3,13,589,576,97.8,2.2
7,1,1,123,4,5,408,403,98.8,1.2
7,1,1,123,5,5,293,288,98.3,1.7
7,1,1,123,6,1,212,211,99.5,0.5
7,1,1,123,7,1,150,149,99.3,0.700000000000003
7,1,1,123,8,0,77,77,100,0
7,1,1,123,9,0,56,56,100,0
7,1,1,123,10,0,32,32,100,0
7,1,1,123,11,0,21,21,100,0
7,1,1,123,12,0,15,15,100,0
7,1,1,123,13,0,10,10,100,0
7,1,1,123,14,0,6,6,100,0
7,1,1,123,15,0,2,2,100,0
7,1,1,123,18,0,2,2,100,0
7,1,2,0,-24,1,1,0,0,100
7,1,2,0,-22,1,1,0,0,100
7,1,2,0,-20,2,2,0,0,100
7,1,2,0,-19,4,4,0,0,100
7,1,2,0,-18,3,3,0,0,100
7,1,2,0,-17,7,7,0,0,100
7,1,2,0,-16,10,10,0,0,100
7,1,2,0,-15,21,21,0,0,100
7,1,2,0,-14,33,33,0,0,100
7,1,2,0,-13,59,59,0,0,100
7,1,2,0,-12,125,125,0,0,100
7,1,2,0,-11,185,186,1,0.5,99.5
7,1,2,0,-10,282,282,0,0,100
7,1,2,0,-9,460,460,0,0,100
7,1,2,0,-8,765,766,1,0.1,99.9
7,1,2,0,-7,1159,1164,5,0.4,99.6
7,1,2,0,-6,1807,1822,15,0.8,99.2
7,1,2,0,-5,2639,2683,44,1.6,98.4
7,1,2,0,-4,3636,3762,126,3.3,96.7
7,1,2,0,-3,4830,5167,337,6.5,93.5
7,1,2,0,-2,5965,6939,974,14,86
7,1,2,0,-1,5998,8115,2117,26.1,73.9
7,1,2,0,0,4304,8931,4627,51.8,48.2
7,1,2,0,1,1943,8440,6497,77,23
7,1,2,0,2,772,6978,6206,88.9,11.1
7,1,2,0,3,303,5510,5207,94.5,5.5
7,1,2,0,4,98,4026,3928,97.6,2.40000000000001
7,1,2,0,5,28,2942,2914,99,1
7,1,2,0,6,8,1956,1948,99.6,0.400000000000006
7,1,2,0,7,0,1322,1322,100,0
7,1,2,0,8,0,841,841,100,0
7,1,2,0,9,0,520,520,100,0
7,1,2,0,10,0,358,358,100,0
7,1,2,0,11,0,208,208,100,0
7,1,2,0,12,0,123,123,100,0
7,1,2,0,13,0,90,90,100,0
7,1,2,0,14,0,41,41,100,0
7,1,2,0,15,0,29,29,100,0
7,1,2,0,16,0,14,14,100,0
7,1,2,0,17,0,4,4,100,0
7,1,2,0,18,0,4,4,100,0
7,1,2,0,19,0,3,3,100,0
7,1,2,0,20,0,1,1,100,0
7,1,2,0,21,0,1,1,100,0
7,1,2,0,22,0,1,1,100,0
7,1,2,1,-24,1,1,0,0,100
7,1,2,1,-21,1,1,0,0,100
7,1,2,1,-18,1,1,0,0,100
7,1,2,1,-17,2,2,0,0,100
7,1,2,1,-16,7,7,0,0,100
7,1,2,1,-15,12,12,0,0,100
7,1,2,1,-14,23,23,0,0,100
7,1,2,1,-13,27,27,0,0,100
7,1,2,1,-12,61,61,0,0,100
7,1,2,1,-11,107,108,1,0.9,99.1
7,1,2,1,-10,172,172,0,0,100
7,1,2,1,-9,227,227,0,0,100
7,1,2,1,-8,438,438,0,0,100
7,1,2,1,-7,708,709,1,0.1,99.9
7,1,2,1,-6,1000,1011,11,1.1,98.9
7,1,2,1,-5,1524,1562,38,2.4,97.6
7,1,2,1,-4,2117,2216,99,4.5,95.5
7,1,2,1,-3,2650,2893,243,8.4,91.6
7,1,2,1,-2,3132,3739,607,16.2,83.8
7,1,2,1,-1,3131,4398,1267,28.8,71.2
7,1,2,1,0,2231,4797,2566,53.5,46.5
7,1,2,1,1,868,4252,3384,79.6,20.4
7,1,2,1,2,379,3642,3263,89.6,10.4
7,1,2,1,3,119,2877,2758,95.9,4.10000000000001
7,1,2,1,4,44,2253,2209,98,2
7,1,2,1,5,19,1693,1674,98.9,1.09999999999999
7,1,2,1,6,4,1277,1273,99.7,0.299999999999997
7,1,2,1,7,2,875,873,99.8,0.200000000000003
7,1,2,1,8,3,559,556,99.5,0.5
7,1,2,1,9,0,413,413,100,0
7,1,2,1,10,0,252,252,100,0
7,1,2,1,11,0,132,132,100,0
7,1,2,1,12,0,94,94,100,0
7,1,2,1,13,0,48,48,100,0
7,1,2,1,14,0,28,28,100,0
7,1,2,1,15,0,18,18,100,0
7,1,2,1,16,0,11,11,100,0
7,1,2,1,17,0,5,5,100,0
7,1,2,1,18,0,3,3,100,0
7,1,2,1,19,0,3,3,100,0
7,1,2,1,20,0,1,1,100,0
7,1,2,1,22,0,1,1,100,0
7,1,2,2,-21,1,1,0,0,100
7,1,2,2,-20,1,1,0,0,100
7,1,2,2,-19,1,1,0,0,100
7,1,2,2,-17,1,1,0,0,100
7,1,2,2,-15,7,7,0,0,100
7,1,2,2,-14,6,6,0,0,100
7,1,2,2,-13,9,9,0,0,100
7,1,2,2,-12,23,23,0,0,100
7,1,2,2,-11,42,42,0,0,100
7,1,2,2,-10,78,78,0,0,100
7,1,2,2,-9,89,89,0,0,100
7,1,2,2,-8,187,187,0,0,100
7,1,2,2,-7,246,246,0,0,100
7,1,2,2,-6,383,392,9,2.3,97.7
7,1,2,2,-5,600,618,18,2.9,97.1
7,1,2,2,-4,753,790,37,4.7,95.3
7,1,2,2,-3,1052,1147,95,8.3,91.7
7,1,2,2,-2,1318,1622,304,18.7,81.3
7,1,2,2,-1,1665,2403,738,30.7,69.3
7,1,2,2,0,1211,2912,1701,58.4,41.6
7,1,2,2,1,567,2753,2186,79.4,20.6
7,1,2,2,2,208,2301,2093,91,9
7,1,2,2,3,80,1889,1809,95.8,4.2
7,1,2,2,4,30,1497,1467,98,2
7,1,2,2,5,10,1089,1079,99.1,0.900000000000006
7,1,2,2,6,3,649,646,99.5,0.5
7,1,2,2,7,1,410,409,99.8,0.200000000000003
7,1,2,2,8,0,299,299,100,0
7,1,2,2,9,0,205,205,100,0
7,1,2,2,10,0,123,123,100,0
7,1,2,2,11,0,75,75,100,0
7,1,2,2,12,0,51,51,100,0
7,1,2,2,13,0,30,30,100,0
7,1,2,2,14,0,18,18,100,0
7,1,2,2,15,0,10,10,100,0
7,1,2,2,16,0,8,8,100,0
7,1,2,2,18,0,5,5,100,0
7,1,2,2,21,0,1,1,100,0
7,1,2,12,-20,1,1,0,0,100
7,1,2,12,-17,2,2,0,0,100
7,1,2,12,-16,3,3,0,0,100
7,1,2,12,-15,2,2,0,0,100
7,1,2,12,-14,8,8,0,0,100
7,1,2,12,-13,7,7,0,0,100
7,1,2,12,-12,38,38,0,0,100
7,1,2,12,-11,44,45,1,2.2,97.8
7,1,2,12,-10,72,72,0,0,100
7,1,2,12,-9,103,104,1,1,99
7,1,2,12,-8,136,136,0,0,100
7,1,2,12,-7,297,300,3,1,99
7,1,2,12,-6,426,431,5,1.2,98.8
7,1,2,12,-5,649,669,20,3,97
7,1,2,12,-4,871,924,53,5.7,94.3
7,1,2,12,-3,1095,1207,112,9.3,90.7
7,1,2,12,-2,1279,1612,333,20.7,79.3
7,1,2,12,-1,1318,1949,631,32.4,67.6
7,1,2,12,0,1039,2603,1564,60.1,39.9
7,1,2,12,1,450,2402,1952,81.3,18.7
7,1,2,12,2,153,2008,1855,92.4,7.59999999999999
7,1,2,12,3,69,1642,1573,95.8,4.2
7,1,2,12,4,28,1301,1273,97.8,2.2
7,1,2,12,5,9,998,989,99.1,0.900000000000006
7,1,2,12,6,1,673,672,99.9,0.0999999999999943
7,1,2,12,7,2,444,442,99.5,0.5
7,1,2,12,8,0,329,329,100,0
7,1,2,12,9,1,215,214,99.5,0.5
7,1,2,12,10,0,135,135,100,0
7,1,2,12,11,0,85,85,100,0
7,1,2,12,12,0,48,48,100,0
7,1,2,12,13,0,28,28,100,0
7,1,2,12,14,0,22,22,100,0
7,1,2,12,15,0,12,12,100,0
7,1,2,12,16,0,8,8,100,0
7,1,2,12,17,0,4,4,100,0
7,1,2,12,19,0,3,3,100,0
7,1,2,3,-15,2,2,0,0,100
7,1,2,3,-14,8,8,0,0,100
7,1,2,3,-13,8,8,0,0,100
7,1,2,3,-12,7,7,0,0,100
7,1,2,3,-11,14,14,0,0,100
7,1,2,3,-10,18,18,0,0,100
7,1,2,3,-9,44,44,0,0,100
7,1,2,3,-8,64,64,0,0,100
7,1,2,3,-7,88,88,0,0,100
7,1,2,3,-6,133,134,1,0.7,99.3
7,1,2,3,-5,209,215,6,2.8,97.2
7,1,2,3,-4,303,319,16,5,95
7,1,2,3,-3,415,455,40,8.8,91.2
7,1,2,3,-2,503,612,109,17.8,82.2
7,1,2,3,-1,698,1020,322,31.6,68.4
7,1,2,3,0,480,1165,685,58.8,41.2
7,1,2,3,1,208,1032,824,79.8,20.2
7,1,2,3,2,87,975,888,91.1,8.89999999999999
7,1,2,3,3,37,757,720,95.1,4.90000000000001
7,1,2,3,4,12,631,619,98.1,1.90000000000001
7,1,2,3,5,1,406,405,99.8,0.200000000000003
7,1,2,3,6,2,262,260,99.2,0.799999999999997
7,1,2,3,7,0,184,184,100,0
7,1,2,3,8,0,146,146,100,0
7,1,2,3,9,0,92,92,100,0
7,1,2,3,10,0,47,47,100,0
7,1,2,3,11,0,35,35,100,0
7,1,2,3,12,0,17,17,100,0
7,1,2,3,13,0,15,15,100,0
7,1,2,3,14,0,7,7,100,0
7,1,2,3,15,0,3,3,100,0
7,1,2,3,16,0,2,2,100,0
7,1,2,3,17,0,1,1,100,0
7,1,2,13,-17,1,1,0,0,100
7,1,2,13,-16,2,2,0,0,100
7,1,2,13,-15,2,2,0,0,100
7,1,2,13,-14,4,4,0,0,100
7,1,2,13,-13,6,6,0,0,100
7,1,2,13,-12,7,7,0,0,100
7,1,2,13,-11,12,12,0,0,100
7,1,2,13,-10,21,21,0,0,100
7,1,2,13,-9,35,35,0,0,100
7,1,2,13,-8,69,69,0,0,100
7,1,2,13,-7,96,97,1,1,99
7,1,2,13,-6,134,137,3,2.2,97.8
7,1,2,13,-5,257,270,13,4.8,95.2
7,1,2,13,-4,351,374,23,6.1,93.9
7,1,2,13,-3,454,500,46,9.2,90.8
7,1,2,13,-2,596,752,156,20.7,79.3
7,1,2,13,-1,586,914,328,35.9,64.1
7,1,2,13,0,471,1187,716,60.3,39.7
7,1,2,13,1,221,1131,910,80.5,19.5
7,1,2,13,2,84,990,906,91.5,8.5
7,1,2,13,3,23,824,801,97.2,2.8
7,1,2,13,4,17,637,620,97.3,2.7
7,1,2,13,5,4,529,525,99.2,0.799999999999997
7,1,2,13,6,3,339,336,99.1,0.900000000000006
7,1,2,13,7,1,245,244,99.6,0.400000000000006
7,1,2,13,8,0,143,143,100,0
7,1,2,13,9,0,120,120,100,0
7,1,2,13,10,0,68,68,100,0
7,1,2,13,11,0,30,30,100,0
7,1,2,13,12,0,18,18,100,0
7,1,2,13,13,0,13,13,100,0
7,1,2,13,14,0,6,6,100,0
7,1,2,13,15,0,2,2,100,0
7,1,2,13,16,0,2,2,100,0
7,1,2,13,17,0,1,1,100,0
7,1,2,13,18,0,2,2,100,0
7,1,2,13,20,0,1,1,100,0
7,1,2,23,-16,1,1,0,0,100
7,1,2,23,-15,1,1,0,0,100
7,1,2,23,-13,4,4,0,0,100
7,1,2,23,-12,7,7,0,0,100
7,1,2,23,-11,8,8,0,0,100
7,1,2,23,-10,14,14,0,0,100
7,1,2,23,-9,24,24,0,0,100
7,1,2,23,-8,42,42,0,0,100
7,1,2,23,-7,55,56,1,1.8,98.2
7,1,2,23,-6,86,88,2,2.3,97.7
7,1,2,23,-5,174,179,5,2.8,97.2
7,1,2,23,-4,198,212,14,6.6,93.4
7,1,2,23,-3,285,322,37,11.5,88.5
7,1,2,23,-2,359,466,107,23,77
7,1,2,23,-1,290,490,200,40.8,59.2
7,1,2,23,0,256,603,347,57.5,42.5
7,1,2,23,1,147,747,600,80.3,19.7
7,1,2,23,2,55,639,584,91.4,8.59999999999999
7,1,2,23,3,18,519,501,96.5,3.5
7,1,2,23,4,12,428,416,97.2,2.8
7,1,2,23,5,1,298,297,99.7,0.299999999999997
7,1,2,23,6,2,234,232,99.1,0.900000000000006
7,1,2,23,7,0,147,147,100,0
7,1,2,23,8,0,92,92,100,0
7,1,2,23,9,0,59,59,100,0
7,1,2,23,10,1,37,36,97.3,2.7
7,1,2,23,11,0,34,34,100,0
7,1,2,23,12,0,17,17,100,0
7,1,2,23,13,0,8,8,100,0
7,1,2,23,14,0,3,3,100,0
7,1,2,23,15,0,2,2,100,0
7,1,2,23,16,0,4,4,100,0
7,1,2,23,19,0,2,2,100,0
7,1,2,123,-16,1,1,0,0,100
7,1,2,123,-15,2,2,0,0,100
7,1,2,123,-14,1,1,0,0,100
7,1,2,123,-12,8,8,0,0,100
7,1,2,123,-11,11,12,1,8.3,91.7
7,1,2,123,-10,16,16,0,0,100
7,1,2,123,-9,25,25,0,0,100
7,1,2,123,-8,40,41,1,2.4,97.6
7,1,2,123,-7,76,76,0,0,100
7,1,2,123,-6,110,111,1,0.9,99.1
7,1,2,123,-5,161,173,12,6.9,93.1
7,1,2,123,-4,246,273,27,9.9,90.1
7,1,2,123,-3,291,342,51,14.9,85.1
7,1,2,123,-2,400,538,138,25.7,74.3
7,1,2,123,-1,398,683,285,41.7,58.3
7,1,2,123,0,335,934,599,64.1,35.9
7,1,2,123,1,181,968,787,81.3,18.7
7,1,2,123,2,69,858,789,92,8
7,1,2,123,3,15,690,675,97.8,2.2
7,1,2,123,4,10,520,510,98.1,1.90000000000001
7,1,2,123,5,6,363,357,98.3,1.7
7,1,2,123,6,2,286,284,99.3,0.700000000000003
7,1,2,123,7,0,160,160,100,0
7,1,2,123,8,0,130,130,100,0
7,1,2,123,9,0,80,80,100,0
7,1,2,123,10,0,44,44,100,0
7,1,2,123,11,0,30,30,100,0
7,1,2,123,12,0,15,15,100,0
7,1,2,123,13,0,12,12,100,0
7,1,2,123,14,0,11,11,100,0
7,1,2,123,15,0,4,4,100,0
7,1,2,123,16,0,2,2,100,0
7,1,2,123,17,0,1,1,100,0
7,1,2,123,18,0,1,1,100,0
7,1,2,123,19,0,1,1,100,0
8,0,0,0,-25,1,1,0,0,100
8,0,0,0,-24,1,1,0,0,100
8,0,0,0,-22,1,1,0,0,100
8,0,0,0,-21,1,1,0,0,100
8,0,0,0,-20,3,3,0,0,100
8,0,0,0,-19,6,6,0,0,100
8,0,0,0,-18,4,4,0,0,100
8,0,0,0,-17,11,11,0,0,100
8,0,0,0,-16,16,16,0,0,100
8,0,0,0,-15,36,36,0,0,100
8,0,0,0,-14,73,73,0,0,100
8,0,0,0,-13,100,100,0,0,100
8,0,0,0,-12,200,200,0,0,100
8,0,0,0,-11,325,325,0,0,100
8,0,0,0,-10,511,511,0,0,100
8,0,0,0,-9,776,777,1,0.1,99.9
8,0,0,0,-8,1334,1335,1,0.1,99.9
8,0,0,0,-7,2101,2108,7,0.3,99.7
8,0,0,0,-6,3068,3089,21,0.7,99.3
8,0,0,0,-5,4577,4647,70,1.5,98.5
8,0,0,0,-4,6362,6552,190,2.9,97.1
8,0,0,0,-3,8490,8995,505,5.6,94.4
8,0,0,0,-2,10335,11808,1473,12.5,87.5
8,0,0,0,-1,10924,14284,3360,23.5,76.5
8,0,0,0,0,7968,15936,7968,50,50
8,0,0,0,1,3552,14962,11410,76.3,23.7
8,0,0,0,2,1409,12624,11215,88.8,11.2
8,0,0,0,3,547,10098,9551,94.6,5.40000000000001
8,0,0,0,4,208,7793,7585,97.3,2.7
8,0,0,0,5,63,5801,5738,98.9,1.09999999999999
8,0,0,0,6,19,3975,3956,99.5,0.5
8,0,0,0,7,5,2681,2676,99.8,0.200000000000003
8,0,0,0,8,3,1818,1815,99.8,0.200000000000003
8,0,0,0,9,1,1177,1176,99.9,0.0999999999999943
8,0,0,0,10,1,768,767,99.9,0.0999999999999943
8,0,0,0,11,0,458,458,100,0
8,0,0,0,12,0,261,261,100,0
8,0,0,0,13,0,177,177,100,0
8,0,0,0,14,0,88,88,100,0
8,0,0,0,15,0,60,60,100,0
8,0,0,0,16,0,40,40,100,0
8,0,0,0,17,0,10,10,100,0
8,0,0,0,18,0,8,8,100,0
8,0,0,0,19,0,8,8,100,0
8,0,0,0,20,0,3,3,100,0
8,0,0,0,21,0,3,3,100,0
8,0,0,0,22,0,1,1,100,0
8,0,0,1,-19,1,1,0,0,100
8,0,0,1,-17,4,4,0,0,100
8,0,0,1,-16,4,4,0,0,100
8,0,0,1,-15,10,10,0,0,100
8,0,0,1,-14,22,22,0,0,100
8,0,0,1,-13,25,25,0,0,100
8,0,0,1,-12,70,70,0,0,100
8,0,0,1,-11,77,77,0,0,100
8,0,0,1,-10,146,146,0,0,100
8,0,0,1,-9,238,238,0,0,100
8,0,0,1,-8,374,374,0,0,100
8,0,0,1,-7,536,539,3,0.6,99.4
8,0,0,1,-6,802,806,4,0.5,99.5
8,0,0,1,-5,1221,1233,12,1,99
8,0,0,1,-4,1676,1721,45,2.6,97.4
8,0,0,1,-3,2246,2371,125,5.3,94.7
8,0,0,1,-2,2790,3145,355,11.3,88.7
8,0,0,1,-1,2928,3648,720,19.7,80.3
8,0,0,1,0,2402,4208,1806,42.9,57.1
8,0,0,1,1,1261,3925,2664,67.9,32.1
8,0,0,1,2,557,3188,2631,82.5,17.5
8,0,0,1,3,227,2482,2255,90.9,9.09999999999999
8,0,0,1,4,95,1961,1866,95.2,4.80000000000001
8,0,0,1,5,29,1491,1462,98.1,1.90000000000001
8,0,0,1,6,10,996,986,99,1
8,0,0,1,7,3,696,693,99.6,0.400000000000006
8,0,0,1,8,2,458,456,99.6,0.400000000000006
8,0,0,1,9,1,300,299,99.7,0.299999999999997
8,0,0,1,10,1,165,164,99.4,0.599999999999994
8,0,0,1,11,0,142,142,100,0
8,0,0,1,12,0,70,70,100,0
8,0,0,1,13,0,39,39,100,0
8,0,0,1,14,0,22,22,100,0
8,0,0,1,15,0,10,10,100,0
8,0,0,1,16,0,12,12,100,0
8,0,0,1,17,0,3,3,100,0
8,0,0,1,18,0,3,3,100,0
8,0,0,1,19,0,3,3,100,0
8,0,0,1,20,0,1,1,100,0
8,0,0,1,22,0,1,1,100,0
8,0,0,2,-19,1,1,0,0,100
8,0,0,2,-17,3,3,0,0,100
8,0,0,2,-16,1,1,0,0,100
8,0,0,2,-15,4,4,0,0,100
8,0,0,2,-14,2,2,0,0,100
8,0,0,2,-13,6,6,0,0,100
8,0,0,2,-12,16,16,0,0,100
8,0,0,2,-11,25,25,0,0,100
8,0,0,2,-10,50,50,0,0,100
8,0,0,2,-9,78,78,0,0,100
8,0,0,2,-8,102,102,0,0,100
8,0,0,2,-7,147,148,1,0.7,99.3
8,0,0,2,-6,223,224,1,0.4,99.6
8,0,0,2,-5,364,369,5,1.4,98.6
8,0,0,2,-4,524,536,12,2.2,97.8
8,0,0,2,-3,683,713,30,4.2,95.8
8,0,0,2,-2,814,905,91,10.1,89.9
8,0,0,2,-1,859,1021,162,15.9,84.1
8,0,0,2,0,645,1038,393,37.9,62.1
8,0,0,2,1,331,874,543,62.1,37.9
8,0,0,2,2,143,714,571,80,20
8,0,0,2,3,60,534,474,88.8,11.2
8,0,0,2,4,22,430,408,94.9,5.10000000000001
8,0,0,2,5,10,344,334,97.1,2.90000000000001
8,0,0,2,6,1,235,234,99.6,0.400000000000006
8,0,0,2,7,1,160,159,99.4,0.599999999999994
8,0,0,2,8,0,118,118,100,0
8,0,0,2,9,0,60,60,100,0
8,0,0,2,10,0,48,48,100,0
8,0,0,2,11,0,23,23,100,0
8,0,0,2,12,0,9,9,100,0
8,0,0,2,13,0,16,16,100,0
8,0,0,2,14,0,7,7,100,0
8,0,0,2,15,0,5,5,100,0
8,0,0,2,16,0,3,3,100,0
8,0,0,2,20,0,1,1,100,0
8,0,0,12,-17,1,1,0,0,100
8,0,0,12,-16,1,1,0,0,100
8,0,0,12,-15,2,2,0,0,100
8,0,0,12,-14,7,7,0,0,100
8,0,0,12,-13,6,6,0,0,100
8,0,0,12,-12,20,20,0,0,100
8,0,0,12,-11,20,20,0,0,100
8,0,0,12,-10,57,57,0,0,100
8,0,0,12,-9,75,75,0,0,100
8,0,0,12,-8,106,106,0,0,100
8,0,0,12,-7,144,144,0,0,100
8,0,0,12,-6,190,192,2,1,99
8,0,0,12,-5,317,319,2,0.6,99.4
8,0,0,12,-4,441,445,4,0.9,99.1
8,0,0,12,-3,467,491,24,4.9,95.1
8,0,0,12,-2,596,656,60,9.1,90.9
8,0,0,12,-1,611,714,103,14.4,85.6
8,0,0,12,0,503,717,214,29.8,70.2
8,0,0,12,1,347,803,456,56.8,43.2
8,0,0,12,2,230,755,525,69.5,30.5
8,0,0,12,3,109,626,517,82.6,17.4
8,0,0,12,4,46,545,499,91.6,8.39999999999999
8,0,0,12,5,15,396,381,96.2,3.8
8,0,0,12,6,6,256,250,97.7,2.3
8,0,0,12,7,0,179,179,100,0
8,0,0,12,8,1,117,116,99.1,0.900000000000006
8,0,0,12,9,1,79,78,98.7,1.3
8,0,0,12,10,0,30,30,100,0
8,0,0,12,11,0,38,38,100,0
8,0,0,12,12,0,19,19,100,0
8,0,0,12,13,0,10,10,100,0
8,0,0,12,14,0,8,8,100,0
8,0,0,12,15,0,3,3,100,0
8,0,0,12,16,0,2,2,100,0
8,0,0,12,17,0,1,1,100,0
8,0,0,3,-18,1,1,0,0,100
8,0,0,3,-14,1,1,0,0,100
8,0,0,3,-13,2,2,0,0,100
8,0,0,3,-12,2,2,0,0,100
8,0,0,3,-11,8,8,0,0,100
8,0,0,3,-10,6,6,0,0,100
8,0,0,3,-9,14,14,0,0,100
8,0,0,3,-8,16,16,0,0,100
8,0,0,3,-7,37,37,0,0,100
8,0,0,3,-6,58,58,0,0,100
8,0,0,3,-5,86,86,0,0,100
8,0,0,3,-4,110,110,0,0,100
8,0,0,3,-3,155,159,4,2.5,97.5
8,0,0,3,-2,170,185,15,8.1,91.9
8,0,0,3,-1,176,209,33,15.8,84.2
8,0,0,3,0,122,177,55,31.1,68.9
8,0,0,3,1,64,149,85,57,43
8,0,0,3,2,23,132,109,82.6,17.4
8,0,0,3,3,9,85,76,89.4,10.6
8,0,0,3,4,3,59,56,94.9,5.10000000000001
8,0,0,3,5,0,54,54,100,0
8,0,0,3,6,0,35,35,100,0
8,0,0,3,7,0,30,30,100,0
8,0,0,3,8,0,15,15,100,0
8,0,0,3,9,0,9,9,100,0
8,0,0,3,10,0,7,7,100,0
8,0,0,3,11,0,2,2,100,0
8,0,0,3,12,0,1,1,100,0
8,0,0,13,-18,2,2,0,0,100
8,0,0,13,-15,2,2,0,0,100
8,0,0,13,-14,1,1,0,0,100
8,0,0,13,-13,2,2,0,0,100
8,0,0,13,-12,5,5,0,0,100
8,0,0,13,-11,6,6,0,0,100
8,0,0,13,-10,15,15,0,0,100
8,0,0,13,-9,33,33,0,0,100
8,0,0,13,-8,34,34,0,0,100
8,0,0,13,-7,58,59,1,1.7,98.3
8,0,0,13,-6,71,72,1,1.4,98.6
8,0,0,13,-5,118,120,2,1.7,98.3
8,0,0,13,-4,161,164,3,1.8,98.2
8,0,0,13,-3,259,263,4,1.5,98.5
8,0,0,13,-2,304,314,10,3.2,96.8
8,0,0,13,-1,278,314,36,11.5,88.5
8,0,0,13,0,272,365,93,25.5,74.5
8,0,0,13,1,202,355,153,43.1,56.9
8,0,0,13,2,85,273,188,68.9,31.1
8,0,0,13,3,28,185,157,84.9,15.1
8,0,0,13,4,13,147,134,91.2,8.8
8,0,0,13,5,3,99,96,97,3
8,0,0,13,6,2,58,56,96.6,3.40000000000001
8,0,0,13,7,1,52,51,98.1,1.90000000000001
8,0,0,13,8,0,40,40,100,0
8,0,0,13,9,0,18,18,100,0
8,0,0,13,10,1,15,14,93.3,6.69999999999999
8,0,0,13,11,0,4,4,100,0
8,0,0,13,12,0,6,6,100,0
8,0,0,13,13,0,9,9,100,0
8,0,0,13,14,0,1,1,100,0
8,0,0,13,15,0,1,1,100,0
8,0,0,23,-16,1,1,0,0,100
8,0,0,23,-15,1,1,0,0,100
8,0,0,23,-13,2,2,0,0,100
8,0,0,23,-12,6,6,0,0,100
8,0,0,23,-11,3,3,0,0,100
8,0,0,23,-10,12,12,0,0,100
8,0,0,23,-9,18,18,0,0,100
8,0,0,23,-8,29,29,0,0,100
8,0,0,23,-7,30,30,0,0,100
8,0,0,23,-6,67,67,0,0,100
8,0,0,23,-5,82,83,1,1.2,98.8
8,0,0,23,-4,110,111,1,0.9,99.1
8,0,0,23,-3,147,149,2,1.3,98.7
8,0,0,23,-2,143,152,9,5.9,94.1
8,0,0,23,-1,164,183,19,10.4,89.6
8,0,0,23,0,145,192,47,24.5,75.5
8,0,0,23,1,107,161,54,33.5,66.5
8,0,0,23,2,55,157,102,65,35
8,0,0,23,3,22,114,92,80.7,19.3
8,0,0,23,4,5,96,91,94.8,5.2
8,0,0,23,5,6,70,64,91.4,8.59999999999999
8,0,0,23,6,1,54,53,98.1,1.90000000000001
8,0,0,23,7,1,37,36,97.3,2.7
8,0,0,23,8,0,19,19,100,0
8,0,0,23,9,0,11,11,100,0
8,0,0,23,10,0,8,8,100,0
8,0,0,23,11,0,6,6,100,0
8,0,0,23,12,0,1,1,100,0
8,0,0,23,13,0,2,2,100,0
8,0,0,23,15,0,1,1,100,0
8,0,0,123,-16,1,1,0,0,100
8,0,0,123,-15,1,1,0,0,100
8,0,0,123,-14,1,1,0,0,100
8,0,0,123,-13,3,3,0,0,100
8,0,0,123,-12,7,7,0,0,100
8,0,0,123,-11,4,4,0,0,100
8,0,0,123,-10,11,11,0,0,100
8,0,0,123,-9,22,22,0,0,100
8,0,0,123,-8,21,21,0,0,100
8,0,0,123,-7,41,42,1,2.4,97.6
8,0,0,123,-6,67,67,0,0,100
8,0,0,123,-5,104,105,1,1,99
8,0,0,123,-4,136,137,1,0.7,99.3
8,0,0,123,-3,157,159,2,1.3,98.7
8,0,0,123,-2,169,182,13,7.1,92.9
8,0,0,123,-1,193,204,11,5.4,94.6
8,0,0,123,0,184,223,39,17.5,82.5
8,0,0,123,1,119,196,77,39.3,60.7
8,0,0,123,2,75,152,77,50.7,49.3
8,0,0,123,3,38,148,110,74.3,25.7
8,0,0,123,4,18,115,97,84.3,15.7
8,0,0,123,5,5,89,84,94.4,5.60000000000001
8,0,0,123,6,3,64,61,95.3,4.7
8,0,0,123,7,0,36,36,100,0
8,0,0,123,8,1,25,24,96,4
8,0,0,123,9,1,12,11,91.7,8.3
8,0,0,123,10,0,7,7,100,0
8,0,0,123,11,0,6,6,100,0
8,0,0,123,12,0,4,4,100,0
8,0,0,123,13,0,2,2,100,0
8,0,0,123,14,0,1,1,100,0
8,0,0,123,15,0,1,1,100,0
8,0,1,0,-25,1,1,0,0,100
8,0,1,0,-22,2,2,0,0,100
8,0,1,0,-21,3,3,0,0,100
8,0,1,0,-20,4,4,0,0,100
8,0,1,0,-19,4,4,0,0,100
8,0,1,0,-18,3,3,0,0,100
8,0,1,0,-17,8,8,0,0,100
8,0,1,0,-16,14,14,0,0,100
8,0,1,0,-15,28,28,0,0,100
8,0,1,0,-14,54,54,0,0,100
8,0,1,0,-13,84,84,0,0,100
8,0,1,0,-12,151,151,0,0,100
8,0,1,0,-11,260,260,0,0,100
8,0,1,0,-10,375,375,0,0,100
8,0,1,0,-9,569,570,1,0.2,99.8
8,0,1,0,-8,950,951,1,0.1,99.9
8,0,1,0,-7,1562,1567,5,0.3,99.7
8,0,1,0,-6,2267,2282,15,0.7,99.3
8,0,1,0,-5,3325,3384,59,1.7,98.3
8,0,1,0,-4,4649,4795,146,3,97
8,0,1,0,-3,6141,6540,399,6.1,93.9
8,0,1,0,-2,7322,8458,1136,13.4,86.6
8,0,1,0,-1,7594,10260,2666,26,74
8,0,1,0,0,5109,11229,6120,54.5,45.5
8,0,1,0,1,1909,10532,8623,81.9,18.1
8,0,1,0,2,705,8922,8217,92.1,7.89999999999999
8,0,1,0,3,261,7187,6926,96.4,3.60000000000001
8,0,1,0,4,97,5491,5394,98.2,1.8
8,0,1,0,5,27,4036,4009,99.3,0.700000000000003
8,0,1,0,6,8,2757,2749,99.7,0.299999999999997
8,0,1,0,7,1,1840,1839,99.9,0.0999999999999943
8,0,1,0,8,1,1271,1270,99.9,0.0999999999999943
8,0,1,0,9,0,825,825,100,0
8,0,1,0,10,0,548,548,100,0
8,0,1,0,11,0,294,294,100,0
8,0,1,0,12,0,191,191,100,0
8,0,1,0,13,0,118,118,100,0
8,0,1,0,14,0,58,58,100,0
8,0,1,0,15,0,45,45,100,0
8,0,1,0,16,0,25,25,100,0
8,0,1,0,17,0,7,7,100,0
8,0,1,0,18,0,5,5,100,0
8,0,1,0,19,0,5,5,100,0
8,0,1,0,20,0,1,1,100,0
8,0,1,0,21,0,3,3,100,0
8,0,1,1,-21,1,1,0,0,100
8,0,1,1,-20,1,1,0,0,100
8,0,1,1,-19,5,5,0,0,100
8,0,1,1,-18,3,3,0,0,100
8,0,1,1,-17,6,6,0,0,100
8,0,1,1,-16,12,12,0,0,100
8,0,1,1,-15,13,13,0,0,100
8,0,1,1,-14,43,43,0,0,100
8,0,1,1,-13,42,42,0,0,100
8,0,1,1,-12,71,71,0,0,100
8,0,1,1,-11,127,127,0,0,100
8,0,1,1,-10,202,202,0,0,100
8,0,1,1,-9,269,270,1,0.4,99.6
8,0,1,1,-8,455,456,1,0.2,99.8
8,0,1,1,-7,746,748,2,0.3,99.7
8,0,1,1,-6,1029,1038,9,0.9,99.1
8,0,1,1,-5,1474,1492,18,1.2,98.8
8,0,1,1,-4,2015,2082,67,3.2,96.8
8,0,1,1,-3,2613,2763,150,5.4,94.6
8,0,1,1,-2,2957,3428,471,13.7,86.3
8,0,1,1,-1,3098,4042,944,23.4,76.6
8,0,1,1,0,2328,4576,2248,49.1,50.9
8,0,1,1,1,1055,4410,3355,76.1,23.9
8,0,1,1,2,442,3879,3437,88.6,11.4
8,0,1,1,3,179,3010,2831,94.1,5.90000000000001
8,0,1,1,4,75,2381,2306,96.9,3.10000000000001
8,0,1,1,5,16,1744,1728,99.1,0.900000000000006
8,0,1,1,6,4,1167,1163,99.7,0.299999999999997
8,0,1,1,7,2,786,784,99.7,0.299999999999997
8,0,1,1,8,2,540,538,99.6,0.400000000000006
8,0,1,1,9,0,329,329,100,0
8,0,1,1,10,0,232,232,100,0
8,0,1,1,11,0,152,152,100,0
8,0,1,1,12,0,78,78,100,0
8,0,1,1,13,0,48,48,100,0
8,0,1,1,14,0,34,34,100,0
8,0,1,1,15,0,14,14,100,0
8,0,1,1,16,0,15,15,100,0
8,0,1,1,17,0,5,5,100,0
8,0,1,1,18,0,4,4,100,0
8,0,1,1,19,0,5,5,100,0
8,0,1,1,20,0,1,1,100,0
8,0,1,1,21,0,1,1,100,0
8,0,1,1,22,0,1,1,100,0
8,0,1,2,-22,1,1,0,0,100
8,0,1,2,-21,1,1,0,0,100
8,0,1,2,-20,1,1,0,0,100
8,0,1,2,-19,1,1,0,0,100
8,0,1,2,-18,1,1,0,0,100
8,0,1,2,-17,2,2,0,0,100
8,0,1,2,-15,6,6,0,0,100
8,0,1,2,-14,10,10,0,0,100
8,0,1,2,-13,18,18,0,0,100
8,0,1,2,-12,41,41,0,0,100
8,0,1,2,-11,55,55,0,0,100
8,0,1,2,-10,77,77,0,0,100
8,0,1,2,-9,126,126,0,0,100
8,0,1,2,-8,172,173,1,0.6,99.4
8,0,1,2,-7,294,295,1,0.3,99.7
8,0,1,2,-6,453,457,4,0.9,99.1
8,0,1,2,-5,723,732,9,1.2,98.8
8,0,1,2,-4,1045,1062,17,1.6,98.4
8,0,1,2,-3,1436,1519,83,5.5,94.5
8,0,1,2,-2,1769,1988,219,11,89
8,0,1,2,-1,1849,2333,484,20.7,79.3
8,0,1,2,0,1470,2639,1169,44.3,55.7
8,0,1,2,1,554,1952,1398,71.6,28.4
8,0,1,2,2,179,1174,995,84.8,15.2
8,0,1,2,3,62,915,853,93.2,6.8
8,0,1,2,4,17,711,694,97.6,2.40000000000001
8,0,1,2,5,4,525,521,99.2,0.799999999999997
8,0,1,2,6,2,374,372,99.5,0.5
8,0,1,2,7,1,246,245,99.6,0.400000000000006
8,0,1,2,8,1,151,150,99.3,0.700000000000003
8,0,1,2,9,0,105,105,100,0
8,0,1,2,10,0,74,74,100,0
8,0,1,2,11,0,49,49,100,0
8,0,1,2,12,0,17,17,100,0
8,0,1,2,13,0,20,20,100,0
8,0,1,2,14,0,6,6,100,0
8,0,1,2,15,0,9,9,100,0
8,0,1,2,16,0,4,4,100,0
8,0,1,2,19,0,1,1,100,0
8,0,1,2,20,0,1,1,100,0
8,0,1,12,-21,1,1,0,0,100
8,0,1,12,-20,1,1,0,0,100
8,0,1,12,-19,1,1,0,0,100
8,0,1,12,-17,3,3,0,0,100
8,0,1,12,-16,4,4,0,0,100
8,0,1,12,-15,5,5,0,0,100
8,0,1,12,-14,13,13,0,0,100
8,0,1,12,-13,24,24,0,0,100
8,0,1,12,-12,44,44,0,0,100
8,0,1,12,-11,67,67,0,0,100
8,0,1,12,-10,106,106,0,0,100
8,0,1,12,-9,112,112,0,0,100
8,0,1,12,-8,177,179,2,1.1,98.9
8,0,1,12,-7,324,326,2,0.6,99.4
8,0,1,12,-6,433,435,2,0.5,99.5
8,0,1,12,-5,612,616,4,0.6,99.4
8,0,1,12,-4,793,812,19,2.3,97.7
8,0,1,12,-3,997,1062,65,6.1,93.9
8,0,1,12,-2,1303,1462,159,10.9,89.1
8,0,1,12,-1,1271,1614,343,21.3,78.7
8,0,1,12,0,1020,1758,738,42,58
8,0,1,12,1,459,1430,971,67.9,32.1
8,0,1,12,2,252,1340,1088,81.2,18.8
8,0,1,12,3,114,1098,984,89.6,10.4
8,0,1,12,4,46,860,814,94.7,5.30000000000001
8,0,1,12,5,12,588,576,98,2
8,0,1,12,6,5,419,414,98.8,1.2
8,0,1,12,7,1,287,286,99.7,0.299999999999997
8,0,1,12,8,1,180,179,99.4,0.599999999999994
8,0,1,12,9,0,111,111,100,0
8,0,1,12,10,0,62,62,100,0
8,0,1,12,11,0,56,56,100,0
8,0,1,12,12,0,25,25,100,0
8,0,1,12,13,0,19,19,100,0
8,0,1,12,14,0,9,9,100,0
8,0,1,12,15,0,4,4,100,0
8,0,1,12,16,0,3,3,100,0
8,0,1,12,17,0,4,4,100,0
8,0,1,12,18,0,2,2,100,0
8,0,1,12,19,0,2,2,100,0
8,0,1,3,-18,1,1,0,0,100
8,0,1,3,-17,1,1,0,0,100
8,0,1,3,-15,2,2,0,0,100
8,0,1,3,-14,3,3,0,0,100
8,0,1,3,-13,8,8,0,0,100
8,0,1,3,-12,11,11,0,0,100
8,0,1,3,-11,18,18,0,0,100
8,0,1,3,-10,26,26,0,0,100
8,0,1,3,-9,44,44,0,0,100
8,0,1,3,-8,66,66,0,0,100
8,0,1,3,-7,109,110,1,0.9,99.1
8,0,1,3,-6,157,158,1,0.6,99.4
8,0,1,3,-5,238,239,1,0.4,99.6
8,0,1,3,-4,353,362,9,2.5,97.5
8,0,1,3,-3,520,541,21,3.9,96.1
8,0,1,3,-2,571,633,62,9.8,90.2
8,0,1,3,-1,589,736,147,20,80
8,0,1,3,0,446,703,257,36.6,63.4
8,0,1,3,1,184,522,338,64.8,35.2
8,0,1,3,2,49,335,286,85.4,14.6
8,0,1,3,3,13,247,234,94.7,5.30000000000001
8,0,1,3,4,3,193,190,98.4,1.59999999999999
8,0,1,3,5,2,157,155,98.7,1.3
8,0,1,3,6,0,95,95,100,0
8,0,1,3,7,0,66,66,100,0
8,0,1,3,8,0,48,48,100,0
8,0,1,3,9,0,24,24,100,0
8,0,1,3,10,0,16,16,100,0
8,0,1,3,11,0,7,7,100,0
8,0,1,3,12,0,7,7,100,0
8,0,1,3,13,0,4,4,100,0
8,0,1,3,14,0,1,1,100,0
8,0,1,13,-22,2,2,0,0,100
8,0,1,13,-18,2,2,0,0,100
8,0,1,13,-17,1,1,0,0,100
8,0,1,13,-15,2,2,0,0,100
8,0,1,13,-14,3,3,0,0,100
8,0,1,13,-13,6,6,0,0,100
8,0,1,13,-12,22,22,0,0,100
8,0,1,13,-11,23,23,0,0,100
8,0,1,13,-10,38,38,0,0,100
8,0,1,13,-9,48,48,0,0,100
8,0,1,13,-8,92,92,0,0,100
8,0,1,13,-7,123,123,0,0,100
8,0,1,13,-6,217,218,1,0.5,99.5
8,0,1,13,-5,278,279,1,0.4,99.6
8,0,1,13,-4,372,381,9,2.4,97.6
8,0,1,13,-3,528,548,20,3.6,96.4
8,0,1,13,-2,637,690,53,7.7,92.3
8,0,1,13,-1,650,790,140,17.7,82.3
8,0,1,13,0,527,816,289,35.4,64.6
8,0,1,13,1,273,704,431,61.2,38.8
8,0,1,13,2,91,464,373,80.4,19.6
8,0,1,13,3,44,348,304,87.4,12.6
8,0,1,13,4,12,290,278,95.9,4.10000000000001
8,0,1,13,5,7,226,219,96.9,3.10000000000001
8,0,1,13,6,0,135,135,100,0
8,0,1,13,7,1,97,96,99,1
8,0,1,13,8,0,59,59,100,0
8,0,1,13,9,0,39,39,100,0
8,0,1,13,10,1,25,24,96,4
8,0,1,13,11,0,20,20,100,0
8,0,1,13,12,0,7,7,100,0
8,0,1,13,13,0,9,9,100,0
8,0,1,13,14,0,5,5,100,0
8,0,1,13,15,0,2,2,100,0
8,0,1,13,16,0,1,1,100,0
8,0,1,13,17,0,1,1,100,0
8,0,1,13,18,0,1,1,100,0
8,0,1,23,-22,1,1,0,0,100
8,0,1,23,-21,1,1,0,0,100
8,0,1,23,-17,1,1,0,0,100
8,0,1,23,-16,1,1,0,0,100
8,0,1,23,-15,5,5,0,0,100
8,0,1,23,-14,1,1,0,0,100
8,0,1,23,-13,8,8,0,0,100
8,0,1,23,-12,12,12,0,0,100
8,0,1,23,-11,15,15,0,0,100
8,0,1,23,-10,23,23,0,0,100
8,0,1,23,-9,27,27,0,0,100
8,0,1,23,-8,66,66,0,0,100
8,0,1,23,-7,111,111,0,0,100
8,0,1,23,-6,141,142,1,0.7,99.3
8,0,1,23,-5,233,233,0,0,100
8,0,1,23,-4,322,329,7,2.1,97.9
8,0,1,23,-3,424,440,16,3.6,96.4
8,0,1,23,-2,477,508,31,6.1,93.9
8,0,1,23,-1,473,568,95,16.7,83.3
8,0,1,23,0,397,554,157,28.3,71.7
8,0,1,23,1,236,513,277,54,46
8,0,1,23,2,97,392,295,75.3,24.7
8,0,1,23,3,29,230,201,87.4,12.6
8,0,1,23,4,15,199,184,92.5,7.5
8,0,1,23,5,3,132,129,97.7,2.3
8,0,1,23,6,3,104,101,97.1,2.90000000000001
8,0,1,23,7,0,75,75,100,0
8,0,1,23,8,1,47,46,97.9,2.10000000000001
8,0,1,23,9,0,32,32,100,0
8,0,1,23,10,0,20,20,100,0
8,0,1,23,11,0,12,12,100,0
8,0,1,23,12,0,5,5,100,0
8,0,1,23,13,0,3,3,100,0
8,0,1,23,14,0,3,3,100,0
8,0,1,23,15,0,3,3,100,0
8,0,1,23,16,0,2,2,100,0
8,0,1,23,19,0,1,1,100,0
8,0,1,123,-18,1,1,0,0,100
8,0,1,123,-15,3,3,0,0,100
8,0,1,123,-14,6,6,0,0,100
8,0,1,123,-13,9,9,0,0,100
8,0,1,123,-12,19,19,0,0,100
8,0,1,123,-11,23,23,0,0,100
8,0,1,123,-10,37,37,0,0,100
8,0,1,123,-9,37,37,0,0,100
8,0,1,123,-8,57,57,0,0,100
8,0,1,123,-7,109,110,1,0.9,99.1
8,0,1,123,-6,168,168,0,0,100
8,0,1,123,-5,280,282,2,0.7,99.3
8,0,1,123,-4,359,370,11,3,97
8,0,1,123,-3,431,445,14,3.1,96.9
8,0,1,123,-2,552,598,46,7.7,92.3
8,0,1,123,-1,546,648,102,15.7,84.3
8,0,1,123,0,523,712,189,26.5,73.5
8,0,1,123,1,247,531,284,53.5,46.5
8,0,1,123,2,89,309,220,71.2,28.8
8,0,1,123,3,56,288,232,80.6,19.4
8,0,1,123,4,27,227,200,88.1,11.9
8,0,1,123,5,6,154,148,96.1,3.90000000000001
8,0,1,123,6,4,119,115,96.6,3.40000000000001
8,0,1,123,7,0,79,79,100,0
8,0,1,123,8,1,53,52,98.1,1.90000000000001
8,0,1,123,9,0,28,28,100,0
8,0,1,123,10,0,15,15,100,0
8,0,1,123,11,0,13,13,100,0
8,0,1,123,12,0,4,4,100,0
8,0,1,123,13,0,5,5,100,0
8,0,1,123,14,0,4,4,100,0
8,0,1,123,16,0,1,1,100,0
8,0,1,123,17,0,2,2,100,0
8,0,1,123,18,0,1,1,100,0
8,0,2,0,-25,1,1,0,0,100
8,0,2,0,-22,1,1,0,0,100
8,0,2,0,-21,3,3,0,0,100
8,0,2,0,-20,3,3,0,0,100
8,0,2,0,-19,5,5,0,0,100
8,0,2,0,-18,2,2,0,0,100
8,0,2,0,-17,7,7,0,0,100
8,0,2,0,-16,9,9,0,0,100
8,0,2,0,-15,27,27,0,0,100
8,0,2,0,-14,48,48,0,0,100
8,0,2,0,-13,72,72,0,0,100
8,0,2,0,-12,133,133,0,0,100
8,0,2,0,-11,246,246,0,0,100
8,0,2,0,-10,317,317,0,0,100
8,0,2,0,-9,515,515,0,0,100
8,0,2,0,-8,823,824,1,0.1,99.9
8,0,2,0,-7,1280,1287,7,0.5,99.5
8,0,2,0,-6,1924,1934,10,0.5,99.5
8,0,2,0,-5,2707,2759,52,1.9,98.1
8,0,2,0,-4,3806,3934,128,3.3,96.7
8,0,2,0,-3,4950,5310,360,6.8,93.2
8,0,2,0,-2,5830,6772,942,13.9,86.1
8,0,2,0,-1,5885,8116,2231,27.5,72.5
8,0,2,0,0,3603,8579,4976,58,42
8,0,2,0,1,1161,8116,6955,85.7,14.3
8,0,2,0,2,404,6857,6453,94.1,5.90000000000001
8,0,2,0,3,125,5553,5428,97.7,2.3
8,0,2,0,4,45,4146,4101,98.9,1.09999999999999
8,0,2,0,5,16,3021,3005,99.5,0.5
8,0,2,0,6,4,2107,2103,99.8,0.200000000000003
8,0,2,0,7,0,1412,1412,100,0
8,0,2,0,8,0,974,974,100,0
8,0,2,0,9,0,629,629,100,0
8,0,2,0,10,0,381,381,100,0
8,0,2,0,11,0,206,206,100,0
8,0,2,0,12,0,149,149,100,0
8,0,2,0,13,0,78,78,100,0
8,0,2,0,14,0,42,42,100,0
8,0,2,0,15,0,32,32,100,0
8,0,2,0,16,0,18,18,100,0
8,0,2,0,17,0,4,4,100,0
8,0,2,0,18,0,3,3,100,0
8,0,2,0,19,0,3,3,100,0
8,0,2,0,20,0,1,1,100,0
8,0,2,0,21,0,2,2,100,0
8,0,2,1,-21,1,1,0,0,100
8,0,2,1,-20,1,1,0,0,100
8,0,2,1,-19,3,3,0,0,100
8,0,2,1,-18,6,6,0,0,100
8,0,2,1,-17,5,5,0,0,100
8,0,2,1,-16,9,9,0,0,100
8,0,2,1,-15,24,24,0,0,100
8,0,2,1,-14,41,41,0,0,100
8,0,2,1,-13,39,39,0,0,100
8,0,2,1,-12,92,92,0,0,100
8,0,2,1,-11,150,150,0,0,100
8,0,2,1,-10,209,209,0,0,100
8,0,2,1,-9,367,368,1,0.3,99.7
8,0,2,1,-8,564,564,0,0,100
8,0,2,1,-7,816,818,2,0.2,99.8
8,0,2,1,-6,1196,1205,9,0.7,99.3
8,0,2,1,-5,1574,1597,23,1.4,98.6
8,0,2,1,-4,2144,2221,77,3.5,96.5
8,0,2,1,-3,2571,2759,188,6.8,93.2
8,0,2,1,-2,2957,3458,501,14.5,85.5
8,0,2,1,-1,3015,4048,1033,25.5,74.5
8,0,2,1,0,1987,4498,2511,55.8,44.2
8,0,2,1,1,813,4460,3647,81.8,18.2
8,0,2,1,2,301,3740,3439,92,8
8,0,2,1,3,96,3025,2929,96.8,3.2
8,0,2,1,4,39,2355,2316,98.3,1.7
8,0,2,1,5,7,1675,1668,99.6,0.400000000000006
8,0,2,1,6,2,1136,1134,99.8,0.200000000000003
8,0,2,1,7,0,748,748,100,0
8,0,2,1,8,1,547,546,99.8,0.200000000000003
8,0,2,1,9,0,366,366,100,0
8,0,2,1,10,0,226,226,100,0
8,0,2,1,11,0,127,127,100,0
8,0,2,1,12,0,85,85,100,0
8,0,2,1,13,0,50,50,100,0
8,0,2,1,14,0,29,29,100,0
8,0,2,1,15,0,16,16,100,0
8,0,2,1,16,0,14,14,100,0
8,0,2,1,17,0,3,3,100,0
8,0,2,1,18,0,1,1,100,0
8,0,2,1,19,0,2,2,100,0
8,0,2,1,20,0,1,1,100,0
8,0,2,1,22,0,1,1,100,0
8,0,2,2,-23,1,1,0,0,100
8,0,2,2,-21,1,1,0,0,100
8,0,2,2,-20,1,1,0,0,100
8,0,2,2,-19,2,2,0,0,100
8,0,2,2,-18,1,1,0,0,100
8,0,2,2,-17,2,2,0,0,100
8,0,2,2,-16,6,6,0,0,100
8,0,2,2,-15,7,7,0,0,100
8,0,2,2,-14,17,17,0,0,100
8,0,2,2,-13,28,28,0,0,100
8,0,2,2,-12,53,53,0,0,100
8,0,2,2,-11,69,69,0,0,100
8,0,2,2,-10,114,114,0,0,100
8,0,2,2,-9,187,187,0,0,100
8,0,2,2,-8,296,296,0,0,100
8,0,2,2,-7,473,473,0,0,100
8,0,2,2,-6,615,621,6,1,99
8,0,2,2,-5,966,977,11,1.1,98.9
8,0,2,2,-4,1415,1455,40,2.7,97.3
8,0,2,2,-3,1659,1764,105,6,94
8,0,2,2,-2,1926,2232,306,13.7,86.3
8,0,2,2,-1,1942,2541,599,23.6,76.4
8,0,2,2,0,1265,2658,1393,52.4,47.6
8,0,2,2,1,450,2177,1727,79.3,20.7
8,0,2,2,2,132,1446,1314,90.9,9.09999999999999
8,0,2,2,3,48,1143,1095,95.8,4.2
8,0,2,2,4,12,868,856,98.6,1.40000000000001
8,0,2,2,5,6,630,624,99,1
8,0,2,2,6,2,463,461,99.6,0.400000000000006
8,0,2,2,7,0,316,316,100,0
8,0,2,2,8,0,199,199,100,0
8,0,2,2,9,0,123,123,100,0
8,0,2,2,10,0,86,86,100,0
8,0,2,2,11,0,54,54,100,0
8,0,2,2,12,0,27,27,100,0
8,0,2,2,13,0,17,17,100,0
8,0,2,2,14,0,3,3,100,0
8,0,2,2,15,0,8,8,100,0
8,0,2,2,16,0,6,6,100,0
8,0,2,2,17,0,2,2,100,0
8,0,2,2,20,0,1,1,100,0
8,0,2,2,21,0,1,1,100,0
8,0,2,12,-23,1,1,0,0,100
8,0,2,12,-22,1,1,0,0,100
8,0,2,12,-21,1,1,0,0,100
8,0,2,12,-20,1,1,0,0,100
8,0,2,12,-19,1,1,0,0,100
8,0,2,12,-18,1,1,0,0,100
8,0,2,12,-17,1,1,0,0,100
8,0,2,12,-16,9,9,0,0,100
8,0,2,12,-15,26,26,0,0,100
8,0,2,12,-14,18,18,0,0,100
8,0,2,12,-13,25,25,0,0,100
8,0,2,12,-12,46,46,0,0,100
8,0,2,12,-11,82,82,0,0,100
8,0,2,12,-10,117,117,0,0,100
8,0,2,12,-9,181,181,0,0,100
8,0,2,12,-8,293,294,1,0.3,99.7
8,0,2,12,-7,449,449,0,0,100
8,0,2,12,-6,617,620,3,0.5,99.5
8,0,2,12,-5,832,843,11,1.3,98.7
8,0,2,12,-4,1120,1165,45,3.9,96.1
8,0,2,12,-3,1458,1561,103,6.6,93.4
8,0,2,12,-2,1749,2021,272,13.5,86.5
8,0,2,12,-1,1634,2160,526,24.4,75.6
8,0,2,12,0,1137,2382,1245,52.3,47.7
8,0,2,12,1,386,1819,1433,78.8,21.2
8,0,2,12,2,189,1575,1386,88,12
8,0,2,12,3,62,1229,1167,95,5
8,0,2,12,4,25,906,881,97.2,2.8
8,0,2,12,5,9,668,659,98.7,1.3
8,0,2,12,6,2,479,477,99.6,0.400000000000006
8,0,2,12,7,0,311,311,100,0
8,0,2,12,8,0,205,205,100,0
8,0,2,12,9,0,144,144,100,0
8,0,2,12,10,0,93,93,100,0
8,0,2,12,11,0,69,69,100,0
8,0,2,12,12,0,34,34,100,0
8,0,2,12,13,0,21,21,100,0
8,0,2,12,14,0,8,8,100,0
8,0,2,12,15,0,6,6,100,0
8,0,2,12,17,0,2,2,100,0
8,0,2,12,19,0,1,1,100,0
8,0,2,3,-22,2,2,0,0,100
8,0,2,3,-17,1,1,0,0,100
8,0,2,3,-15,3,3,0,0,100
8,0,2,3,-14,6,6,0,0,100
8,0,2,3,-13,13,13,0,0,100
8,0,2,3,-12,12,12,0,0,100
8,0,2,3,-11,27,27,0,0,100
8,0,2,3,-10,50,50,0,0,100
8,0,2,3,-9,69,69,0,0,100
8,0,2,3,-8,121,121,0,0,100
8,0,2,3,-7,190,191,1,0.5,99.5
8,0,2,3,-6,271,273,2,0.7,99.3
8,0,2,3,-5,378,383,5,1.3,98.7
8,0,2,3,-4,554,570,16,2.8,97.2
8,0,2,3,-3,711,758,47,6.2,93.8
8,0,2,3,-2,704,815,111,13.6,86.4
8,0,2,3,-1,720,918,198,21.6,78.4
8,0,2,3,0,500,1003,503,50.1,49.9
8,0,2,3,1,158,811,653,80.5,19.5
8,0,2,3,2,50,543,493,90.8,9.2
8,0,2,3,3,14,421,407,96.7,3.3
8,0,2,3,4,7,349,342,98,2
8,0,2,3,5,0,257,257,100,0
8,0,2,3,6,1,175,174,99.4,0.599999999999994
8,0,2,3,7,0,124,124,100,0
8,0,2,3,8,0,67,67,100,0
8,0,2,3,9,0,42,42,100,0
8,0,2,3,10,0,26,26,100,0
8,0,2,3,11,0,18,18,100,0
8,0,2,3,12,0,11,11,100,0
8,0,2,3,13,0,12,12,100,0
8,0,2,3,14,0,6,6,100,0
8,0,2,3,15,0,4,4,100,0
8,0,2,3,16,0,1,1,100,0
8,0,2,3,19,0,1,1,100,0
8,0,2,13,-22,1,1,0,0,100
8,0,2,13,-19,1,1,0,0,100
8,0,2,13,-17,5,5,0,0,100
8,0,2,13,-16,5,5,0,0,100
8,0,2,13,-15,3,3,0,0,100
8,0,2,13,-14,7,7,0,0,100
8,0,2,13,-13,17,17,0,0,100
8,0,2,13,-12,27,27,0,0,100
8,0,2,13,-11,30,30,0,0,100
8,0,2,13,-10,59,59,0,0,100
8,0,2,13,-9,94,94,0,0,100
8,0,2,13,-8,150,150,0,0,100
8,0,2,13,-7,228,228,0,0,100
8,0,2,13,-6,314,315,1,0.3,99.7
8,0,2,13,-5,408,418,10,2.4,97.6
8,0,2,13,-4,549,567,18,3.2,96.8
8,0,2,13,-3,721,771,50,6.5,93.5
8,0,2,13,-2,800,894,94,10.5,89.5
8,0,2,13,-1,804,1044,240,23,77
8,0,2,13,0,573,1132,559,49.4,50.6
8,0,2,13,1,214,866,652,75.3,24.7
8,0,2,13,2,82,644,562,87.3,12.7
8,0,2,13,3,25,517,492,95.2,4.80000000000001
8,0,2,13,4,10,383,373,97.4,2.60000000000001
8,0,2,13,5,3,276,273,98.9,1.09999999999999
8,0,2,13,6,0,185,185,100,0
8,0,2,13,7,0,107,107,100,0
8,0,2,13,8,0,65,65,100,0
8,0,2,13,9,0,48,48,100,0
8,0,2,13,10,0,33,33,100,0
8,0,2,13,11,0,19,19,100,0
8,0,2,13,12,0,12,12,100,0
8,0,2,13,13,0,7,7,100,0
8,0,2,13,14,0,4,4,100,0
8,0,2,13,15,0,2,2,100,0
8,0,2,13,16,0,2,2,100,0
8,0,2,13,17,0,1,1,100,0
8,0,2,13,19,0,1,1,100,0
8,0,2,13,22,0,1,1,100,0
8,0,2,23,-19,1,1,0,0,100
8,0,2,23,-18,1,1,0,0,100
8,0,2,23,-16,1,1,0,0,100
8,0,2,23,-15,2,2,0,0,100
8,0,2,23,-14,5,5,0,0,100
8,0,2,23,-13,14,14,0,0,100
8,0,2,23,-12,20,20,0,0,100
8,0,2,23,-11,22,22,0,0,100
8,0,2,23,-10,25,25,0,0,100
8,0,2,23,-9,46,46,0,0,100
8,0,2,23,-8,109,109,0,0,100
8,0,2,23,-7,127,129,2,1.6,98.4
8,0,2,23,-6,204,204,0,0,100
8,0,2,23,-5,278,281,3,1.1,98.9
8,0,2,23,-4,348,359,11,3.1,96.9
8,0,2,23,-3,455,478,23,4.8,95.2
8,0,2,23,-2,500,559,59,10.6,89.4
8,0,2,23,-1,485,624,139,22.3,77.7
8,0,2,23,0,293,531,238,44.8,55.2
8,0,2,23,1,126,467,341,73,27
8,0,2,23,2,60,435,375,86.2,13.8
8,0,2,23,3,23,280,257,91.8,8.2
8,0,2,23,4,6,206,200,97.1,2.90000000000001
8,0,2,23,5,1,176,175,99.4,0.599999999999994
8,0,2,23,6,1,120,119,99.2,0.799999999999997
8,0,2,23,7,0,87,87,100,0
8,0,2,23,8,0,42,42,100,0
8,0,2,23,9,0,37,37,100,0
8,0,2,23,10,0,24,24,100,0
8,0,2,23,11,0,8,8,100,0
8,0,2,23,12,0,6,6,100,0
8,0,2,23,13,0,3,3,100,0
8,0,2,23,14,0,5,5,100,0
8,0,2,23,15,0,1,1,100,0
8,0,2,23,16,0,1,1,100,0
8,0,2,23,17,0,1,1,100,0
8,0,2,23,18,0,2,2,100,0
8,0,2,23,19,0,1,1,100,0
8,0,2,123,-16,5,5,0,0,100
8,0,2,123,-15,8,8,0,0,100
8,0,2,123,-14,8,8,0,0,100
8,0,2,123,-13,23,23,0,0,100
8,0,2,123,-12,24,24,0,0,100
8,0,2,123,-11,18,18,0,0,100
8,0,2,123,-10,44,44,0,0,100
8,0,2,123,-9,69,69,0,0,100
8,0,2,123,-8,105,105,0,0,100
8,0,2,123,-7,166,166,0,0,100
8,0,2,123,-6,210,212,2,0.9,99.1
8,0,2,123,-5,297,306,9,2.9,97.1
8,0,2,123,-4,425,440,15,3.4,96.6
8,0,2,123,-3,538,566,28,4.9,95.1
8,0,2,123,-2,648,722,74,10.2,89.8
8,0,2,123,-1,641,812,171,21.1,78.9
8,0,2,123,0,492,836,344,41.1,58.9
8,0,2,123,1,171,629,458,72.8,27.2
8,0,2,123,2,71,411,340,82.7,17.3
8,0,2,123,3,32,315,283,89.8,10.2
8,0,2,123,4,10,237,227,95.8,4.2
8,0,2,123,5,4,158,154,97.5,2.5
8,0,2,123,6,1,120,119,99.2,0.799999999999997
8,0,2,123,7,0,91,91,100,0
8,0,2,123,8,0,48,48,100,0
8,0,2,123,9,0,37,37,100,0
8,0,2,123,10,0,17,17,100,0
8,0,2,123,11,0,12,12,100,0
8,0,2,123,12,0,4,4,100,0
8,0,2,123,13,0,3,3,100,0
8,0,2,123,17,0,1,1,100,0
8,0,2,123,18,0,1,1,100,0
8,0,2,123,19,0,1,1,100,0
8,1,0,0,-25,1,1,0,0,100
8,1,0,0,-23,1,1,0,0,100
8,1,0,0,-22,4,4,0,0,100
8,1,0,0,-21,4,4,0,0,100
8,1,0,0,-20,2,2,0,0,100
8,1,0,0,-19,10,10,0,0,100
8,1,0,0,-18,8,8,0,0,100
8,1,0,0,-17,16,16,0,0,100
8,1,0,0,-16,32,32,0,0,100
8,1,0,0,-15,55,55,0,0,100
8,1,0,0,-14,116,116,0,0,100
8,1,0,0,-13,171,171,0,0,100
8,1,0,0,-12,282,282,0,0,100
8,1,0,0,-11,492,492,0,0,100
8,1,0,0,-10,717,717,0,0,100
8,1,0,0,-9,1083,1084,1,0.1,99.9
8,1,0,0,-8,1697,1701,4,0.2,99.8
8,1,0,0,-7,2669,2682,13,0.5,99.5
8,1,0,0,-6,3791,3821,30,0.8,99.2
8,1,0,0,-5,5322,5410,88,1.6,98.4
8,1,0,0,-4,7267,7545,278,3.7,96.3
8,1,0,0,-3,9242,9942,700,7,93
8,1,0,0,-2,10436,12255,1819,14.8,85.2
8,1,0,0,-1,10202,14232,4030,28.3,71.7
8,1,0,0,0,5920,15011,9091,60.6,39.4
8,1,0,0,1,1634,14033,12399,88.4,11.6
8,1,0,0,2,546,11763,11217,95.4,4.60000000000001
8,1,0,0,3,148,9380,9232,98.4,1.59999999999999
8,1,0,0,4,57,7208,7151,99.2,0.799999999999997
8,1,0,0,5,18,5308,5290,99.7,0.299999999999997
8,1,0,0,6,4,3639,3635,99.9,0.0999999999999943
8,1,0,0,7,0,2437,2437,100,0
8,1,0,0,8,1,1640,1639,99.9,0.0999999999999943
8,1,0,0,9,0,1067,1067,100,0
8,1,0,0,10,0,689,689,100,0
8,1,0,0,11,0,413,413,100,0
8,1,0,0,12,0,257,257,100,0
8,1,0,0,13,0,139,139,100,0
8,1,0,0,14,0,88,88,100,0
8,1,0,0,15,0,51,51,100,0
8,1,0,0,16,0,33,33,100,0
8,1,0,0,17,0,13,13,100,0
8,1,0,0,18,0,7,7,100,0
8,1,0,0,19,0,6,6,100,0
8,1,0,0,20,0,3,3,100,0
8,1,0,0,21,0,3,3,100,0
8,1,0,0,22,0,1,1,100,0
8,1,0,0,23,0,1,1,100,0
8,1,0,0,25,0,1,1,100,0
8,1,0,1,-22,2,2,0,0,100
8,1,0,1,-21,2,2,0,0,100
8,1,0,1,-20,1,1,0,0,100
8,1,0,1,-19,2,2,0,0,100
8,1,0,1,-18,3,3,0,0,100
8,1,0,1,-17,4,4,0,0,100
8,1,0,1,-16,13,13,0,0,100
8,1,0,1,-15,18,18,0,0,100
8,1,0,1,-14,29,29,0,0,100
8,1,0,1,-13,60,60,0,0,100
8,1,0,1,-12,90,90,0,0,100
8,1,0,1,-11,120,120,0,0,100
8,1,0,1,-10,200,200,0,0,100
8,1,0,1,-9,286,286,0,0,100
8,1,0,1,-8,433,437,4,0.9,99.1
8,1,0,1,-7,655,664,9,1.4,98.6
8,1,0,1,-6,963,976,13,1.3,98.7
8,1,0,1,-5,1374,1416,42,3,97
8,1,0,1,-4,1785,1910,125,6.5,93.5
8,1,0,1,-3,2297,2630,333,12.7,87.3
8,1,0,1,-2,2531,3262,731,22.4,77.6
8,1,0,1,-1,2357,3788,1431,37.8,62.2
8,1,0,1,0,1331,4116,2785,67.7,32.3
8,1,0,1,1,358,3609,3251,90.1,9.89999999999999
8,1,0,1,2,162,3106,2944,94.8,5.2
8,1,0,1,3,36,2506,2470,98.6,1.40000000000001
8,1,0,1,4,12,1842,1830,99.3,0.700000000000003
8,1,0,1,5,4,1410,1406,99.7,0.299999999999997
8,1,0,1,6,2,926,924,99.8,0.200000000000003
8,1,0,1,7,0,666,666,100,0
8,1,0,1,8,0,451,451,100,0
8,1,0,1,9,0,260,260,100,0
8,1,0,1,10,0,174,174,100,0
8,1,0,1,11,0,105,105,100,0
8,1,0,1,12,0,74,74,100,0
8,1,0,1,13,0,41,41,100,0
8,1,0,1,14,0,21,21,100,0
8,1,0,1,15,0,17,17,100,0
8,1,0,1,16,0,10,10,100,0
8,1,0,1,17,0,6,6,100,0
8,1,0,1,18,0,1,1,100,0
8,1,0,1,19,0,2,2,100,0
8,1,0,1,20,0,3,3,100,0
8,1,0,1,21,0,1,1,100,0
8,1,0,1,23,0,1,1,100,0
8,1,0,2,-19,3,3,0,0,100
8,1,0,2,-17,1,1,0,0,100
8,1,0,2,-16,2,2,0,0,100
8,1,0,2,-15,8,8,0,0,100
8,1,0,2,-14,7,7,0,0,100
8,1,0,2,-13,14,14,0,0,100
8,1,0,2,-12,17,17,0,0,100
8,1,0,2,-11,32,32,0,0,100
8,1,0,2,-10,41,41,0,0,100
8,1,0,2,-9,48,48,0,0,100
8,1,0,2,-8,98,98,0,0,100
8,1,0,2,-7,172,173,1,0.6,99.4
8,1,0,2,-6,218,221,3,1.4,98.6
8,1,0,2,-5,312,319,7,2.2,97.8
8,1,0,2,-4,412,442,30,6.8,93.2
8,1,0,2,-3,509,577,68,11.8,88.2
8,1,0,2,-2,537,750,213,28.4,71.6
8,1,0,2,-1,472,875,403,46.1,53.9
8,1,0,2,0,257,974,717,73.6,26.4
8,1,0,2,1,100,1034,934,90.3,9.7
8,1,0,2,2,36,911,875,96,4
8,1,0,2,3,6,809,803,99.3,0.700000000000003
8,1,0,2,4,5,628,623,99.2,0.799999999999997
8,1,0,2,5,0,448,448,100,0
8,1,0,2,6,0,291,291,100,0
8,1,0,2,7,0,201,201,100,0
8,1,0,2,8,0,115,115,100,0
8,1,0,2,9,0,64,64,100,0
8,1,0,2,10,0,54,54,100,0
8,1,0,2,11,0,36,36,100,0
8,1,0,2,12,0,23,23,100,0
8,1,0,2,13,0,8,8,100,0
8,1,0,2,14,0,5,5,100,0
8,1,0,2,15,0,4,4,100,0
8,1,0,2,16,0,7,7,100,0
8,1,0,2,18,0,1,1,100,0
8,1,0,2,21,0,1,1,100,0
8,1,0,12,-22,1,1,0,0,100
8,1,0,12,-19,1,1,0,0,100
8,1,0,12,-18,1,1,0,0,100
8,1,0,12,-16,3,3,0,0,100
8,1,0,12,-15,4,4,0,0,100
8,1,0,12,-14,6,6,0,0,100
8,1,0,12,-13,16,16,0,0,100
8,1,0,12,-12,19,19,0,0,100
8,1,0,12,-11,33,33,0,0,100
8,1,0,12,-10,56,56,0,0,100
8,1,0,12,-9,75,75,0,0,100
8,1,0,12,-8,114,115,1,0.9,99.1
8,1,0,12,-7,184,187,3,1.6,98.4
8,1,0,12,-6,254,261,7,2.7,97.3
8,1,0,12,-5,340,368,28,7.6,92.4
8,1,0,12,-4,451,511,60,11.7,88.3
8,1,0,12,-3,537,677,140,20.7,79.3
8,1,0,12,-2,537,822,285,34.7,65.3
8,1,0,12,-1,315,730,415,56.8,43.2
8,1,0,12,0,151,757,606,80.1,19.9
8,1,0,12,1,68,730,662,90.7,9.3
8,1,0,12,2,30,632,602,95.3,4.7
8,1,0,12,3,10,563,553,98.2,1.8
8,1,0,12,4,3,454,451,99.3,0.700000000000003
8,1,0,12,5,0,362,362,100,0
8,1,0,12,6,0,263,263,100,0
8,1,0,12,7,0,176,176,100,0
8,1,0,12,8,0,156,156,100,0
8,1,0,12,9,0,96,96,100,0
8,1,0,12,10,0,47,47,100,0
8,1,0,12,11,0,29,29,100,0
8,1,0,12,12,0,22,22,100,0
8,1,0,12,13,0,17,17,100,0
8,1,0,12,14,0,9,9,100,0
8,1,0,12,15,0,6,6,100,0
8,1,0,12,16,0,5,5,100,0
8,1,0,12,17,0,1,1,100,0
8,1,0,12,19,0,2,2,100,0
8,1,0,12,21,0,1,1,100,0
8,1,0,3,-16,1,1,0,0,100
8,1,0,3,-14,2,2,0,0,100
8,1,0,3,-13,2,2,0,0,100
8,1,0,3,-12,2,2,0,0,100
8,1,0,3,-11,7,7,0,0,100
8,1,0,3,-10,11,11,0,0,100
8,1,0,3,-9,13,13,0,0,100
8,1,0,3,-8,19,19,0,0,100
8,1,0,3,-7,23,23,0,0,100
8,1,0,3,-6,40,41,1,2.4,97.6
8,1,0,3,-5,52,52,0,0,100
8,1,0,3,-4,74,80,6,7.5,92.5
8,1,0,3,-3,77,92,15,16.3,83.7
8,1,0,3,-2,97,123,26,21.1,78.9
8,1,0,3,-1,75,159,84,52.8,47.2
8,1,0,3,0,38,204,166,81.4,18.6
8,1,0,3,1,12,199,187,94,6
8,1,0,3,2,8,219,211,96.3,3.7
8,1,0,3,3,1,153,152,99.3,0.700000000000003
8,1,0,3,4,1,134,133,99.3,0.700000000000003
8,1,0,3,5,0,73,73,100,0
8,1,0,3,6,0,57,57,100,0
8,1,0,3,7,0,45,45,100,0
8,1,0,3,8,0,27,27,100,0
8,1,0,3,9,0,20,20,100,0
8,1,0,3,10,0,10,10,100,0
8,1,0,3,11,0,8,8,100,0
8,1,0,3,12,0,4,4,100,0
8,1,0,3,13,0,3,3,100,0
8,1,0,3,14,0,2,2,100,0
8,1,0,3,15,0,1,1,100,0
8,1,0,3,16,0,1,1,100,0
8,1,0,3,18,0,1,1,100,0
8,1,0,13,-18,1,1,0,0,100
8,1,0,13,-17,1,1,0,0,100
8,1,0,13,-16,1,1,0,0,100
8,1,0,13,-15,1,1,0,0,100
8,1,0,13,-14,1,1,0,0,100
8,1,0,13,-13,5,5,0,0,100
8,1,0,13,-12,5,5,0,0,100
8,1,0,13,-11,10,10,0,0,100
8,1,0,13,-10,13,13,0,0,100
8,1,0,13,-9,20,20,0,0,100
8,1,0,13,-8,26,26,0,0,100
8,1,0,13,-7,54,55,1,1.8,98.2
8,1,0,13,-6,60,62,2,3.2,96.8
8,1,0,13,-5,88,91,3,3.3,96.7
8,1,0,13,-4,128,148,20,13.5,86.5
8,1,0,13,-3,164,205,41,20,80
8,1,0,13,-2,166,276,110,39.9,60.1
8,1,0,13,-1,104,280,176,62.9,37.1
8,1,0,13,0,62,328,266,81.1,18.9
8,1,0,13,1,25,326,301,92.3,7.69999999999999
8,1,0,13,2,9,285,276,96.8,3.2
8,1,0,13,3,4,236,232,98.3,1.7
8,1,0,13,4,1,203,202,99.5,0.5
8,1,0,13,5,0,145,145,100,0
8,1,0,13,6,0,85,85,100,0
8,1,0,13,7,0,64,64,100,0
8,1,0,13,8,0,47,47,100,0
8,1,0,13,9,0,22,22,100,0
8,1,0,13,10,0,17,17,100,0
8,1,0,13,11,0,17,17,100,0
8,1,0,13,12,0,4,4,100,0
8,1,0,13,13,0,2,2,100,0
8,1,0,13,14,0,1,1,100,0
8,1,0,13,15,0,1,1,100,0
8,1,0,13,17,0,1,1,100,0
8,1,0,23,-17,2,2,0,0,100
8,1,0,23,-14,1,1,0,0,100
8,1,0,23,-13,4,4,0,0,100
8,1,0,23,-12,8,8,0,0,100
8,1,0,23,-11,5,5,0,0,100
8,1,0,23,-10,15,15,0,0,100
8,1,0,23,-9,11,11,0,0,100
8,1,0,23,-8,18,19,1,5.3,94.7
8,1,0,23,-7,29,31,2,6.5,93.5
8,1,0,23,-6,59,63,4,6.3,93.7
8,1,0,23,-5,57,60,3,5,95
8,1,0,23,-4,64,79,15,19,81
8,1,0,23,-3,105,140,35,25,75
8,1,0,23,-2,93,171,78,45.6,54.4
8,1,0,23,-1,49,148,99,66.9,33.1
8,1,0,23,0,20,160,140,87.5,12.5
8,1,0,23,1,6,178,172,96.6,3.40000000000001
8,1,0,23,2,6,178,172,96.6,3.40000000000001
8,1,0,23,3,0,164,164,100,0
8,1,0,23,4,0,134,134,100,0
8,1,0,23,5,0,93,93,100,0
8,1,0,23,6,0,56,56,100,0
8,1,0,23,7,0,56,56,100,0
8,1,0,23,8,0,32,32,100,0
8,1,0,23,9,0,26,26,100,0
8,1,0,23,10,0,20,20,100,0
8,1,0,23,11,0,8,8,100,0
8,1,0,23,12,0,7,7,100,0
8,1,0,23,13,0,1,1,100,0
8,1,0,23,14,0,1,1,100,0
8,1,0,23,15,0,1,1,100,0
8,1,0,23,16,0,1,1,100,0
8,1,0,23,17,0,1,1,100,0
8,1,0,123,-22,1,1,0,0,100
8,1,0,123,-14,1,1,0,0,100
8,1,0,123,-13,7,7,0,0,100
8,1,0,123,-12,3,3,0,0,100
8,1,0,123,-11,6,6,0,0,100
8,1,0,123,-10,10,10,0,0,100
8,1,0,123,-9,16,16,0,0,100
8,1,0,123,-8,26,27,1,3.7,96.3
8,1,0,123,-7,40,41,1,2.4,97.6
8,1,0,123,-6,59,61,2,3.3,96.7
8,1,0,123,-5,71,82,11,13.4,86.6
8,1,0,123,-4,89,120,31,25.8,74.2
8,1,0,123,-3,94,142,48,33.8,66.2
8,1,0,123,-2,100,186,86,46.2,53.8
8,1,0,123,-1,66,200,134,67,33
8,1,0,123,0,33,239,206,86.2,13.8
8,1,0,123,1,9,242,233,96.3,3.7
8,1,0,123,2,8,227,219,96.5,3.5
8,1,0,123,3,3,165,162,98.2,1.8
8,1,0,123,4,3,136,133,97.8,2.2
8,1,0,123,5,0,99,99,100,0
8,1,0,123,6,0,70,70,100,0
8,1,0,123,7,0,60,60,100,0
8,1,0,123,8,0,41,41,100,0
8,1,0,123,9,0,28,28,100,0
8,1,0,123,10,0,12,12,100,0
8,1,0,123,11,0,10,10,100,0
8,1,0,123,12,0,3,3,100,0
8,1,0,123,13,0,4,4,100,0
8,1,0,123,14,0,3,3,100,0
8,1,0,123,15,0,5,5,100,0
8,1,0,123,16,0,2,2,100,0
8,1,0,123,17,0,1,1,100,0
8,1,0,123,19,0,1,1,100,0
8,1,1,0,-25,1,1,0,0,100
8,1,1,0,-23,1,1,0,0,100
8,1,1,0,-22,2,2,0,0,100
8,1,1,0,-21,2,2,0,0,100
8,1,1,0,-20,1,1,0,0,100
8,1,1,0,-19,5,5,0,0,100
8,1,1,0,-18,6,6,0,0,100
8,1,1,0,-17,11,11,0,0,100
8,1,1,0,-16,14,14,0,0,100
8,1,1,0,-15,32,32,0,0,100
8,1,1,0,-14,79,79,0,0,100
8,1,1,0,-13,101,101,0,0,100
8,1,1,0,-12,172,172,0,0,100
8,1,1,0,-11,336,336,0,0,100
8,1,1,0,-10,479,479,0,0,100
8,1,1,0,-9,755,755,0,0,100
8,1,1,0,-8,1160,1160,0,0,100
8,1,1,0,-7,1853,1856,3,0.2,99.8
8,1,1,0,-6,2634,2649,15,0.6,99.4
8,1,1,0,-5,3683,3724,41,1.1,98.9
8,1,1,0,-4,5122,5234,112,2.1,97.9
8,1,1,0,-3,6571,6860,289,4.2,95.8
8,1,1,0,-2,7617,8511,894,10.5,89.5
8,1,1,0,-1,7713,9924,2211,22.3,77.7
8,1,1,0,0,4604,10342,5738,55.5,44.5
8,1,1,0,1,1274,9980,8706,87.2,12.8
8,1,1,0,2,396,8452,8056,95.3,4.7
8,1,1,0,3,112,6742,6630,98.3,1.7
8,1,1,0,4,43,5231,5188,99.2,0.799999999999997
8,1,1,0,5,14,3855,3841,99.6,0.400000000000006
8,1,1,0,6,2,2683,2681,99.9,0.0999999999999943
8,1,1,0,7,0,1768,1768,100,0
8,1,1,0,8,1,1227,1226,99.9,0.0999999999999943
8,1,1,0,9,0,822,822,100,0
8,1,1,0,10,0,536,536,100,0
8,1,1,0,11,0,320,320,100,0
8,1,1,0,12,0,192,192,100,0
8,1,1,0,13,0,97,97,100,0
8,1,1,0,14,0,73,73,100,0
8,1,1,0,15,0,34,34,100,0
8,1,1,0,16,0,23,23,100,0
8,1,1,0,17,0,10,10,100,0
8,1,1,0,18,0,8,8,100,0
8,1,1,0,19,0,4,4,100,0
8,1,1,0,21,0,2,2,100,0
8,1,1,0,22,0,1,1,100,0
8,1,1,0,25,0,1,1,100,0
8,1,1,0,26,0,1,1,100,0
8,1,1,1,-23,1,1,0,0,100
8,1,1,1,-22,1,1,0,0,100
8,1,1,1,-21,2,2,0,0,100
8,1,1,1,-20,1,1,0,0,100
8,1,1,1,-19,3,3,0,0,100
8,1,1,1,-18,2,2,0,0,100
8,1,1,1,-17,4,4,0,0,100
8,1,1,1,-16,10,10,0,0,100
8,1,1,1,-15,19,19,0,0,100
8,1,1,1,-14,32,32,0,0,100
8,1,1,1,-13,46,46,0,0,100
8,1,1,1,-12,92,92,0,0,100
8,1,1,1,-11,143,143,0,0,100
8,1,1,1,-10,210,210,0,0,100
8,1,1,1,-9,323,323,0,0,100
8,1,1,1,-8,507,507,0,0,100
8,1,1,1,-7,824,827,3,0.4,99.6
8,1,1,1,-6,1142,1151,9,0.8,99.2
8,1,1,1,-5,1634,1658,24,1.4,98.6
8,1,1,1,-4,2205,2281,76,3.3,96.7
8,1,1,1,-3,2772,3012,240,8,92
8,1,1,1,-2,3215,3792,577,15.2,84.8
8,1,1,1,-1,2959,4193,1234,29.4,70.6
8,1,1,1,0,1670,4291,2621,61.1,38.9
8,1,1,1,1,396,3864,3468,89.8,10.2
8,1,1,1,2,169,3518,3349,95.2,4.80000000000001
8,1,1,1,3,46,2856,2810,98.4,1.59999999999999
8,1,1,1,4,11,2235,2224,99.5,0.5
8,1,1,1,5,3,1779,1776,99.8,0.200000000000003
8,1,1,1,6,1,1234,1233,99.9,0.0999999999999943
8,1,1,1,7,0,914,914,100,0
8,1,1,1,8,1,637,636,99.8,0.200000000000003
8,1,1,1,9,0,361,361,100,0
8,1,1,1,10,0,252,252,100,0
8,1,1,1,11,0,154,154,100,0
8,1,1,1,12,0,102,102,100,0
8,1,1,1,13,0,47,47,100,0
8,1,1,1,14,0,32,32,100,0
8,1,1,1,15,0,21,21,100,0
8,1,1,1,16,0,9,9,100,0
8,1,1,1,17,0,8,8,100,0
8,1,1,1,18,0,6,6,100,0
8,1,1,1,19,0,2,2,100,0
8,1,1,1,20,0,2,2,100,0
8,1,1,1,21,0,1,1,100,0
8,1,1,2,-19,1,1,0,0,100
8,1,1,2,-18,1,1,0,0,100
8,1,1,2,-17,1,1,0,0,100
8,1,1,2,-16,3,3,0,0,100
8,1,1,2,-15,8,8,0,0,100
8,1,1,2,-14,14,14,0,0,100
8,1,1,2,-13,20,20,0,0,100
8,1,1,2,-12,24,24,0,0,100
8,1,1,2,-11,56,56,0,0,100
8,1,1,2,-10,77,77,0,0,100
8,1,1,2,-9,109,109,0,0,100
8,1,1,2,-8,187,187,0,0,100
8,1,1,2,-7,253,253,0,0,100
8,1,1,2,-6,339,340,1,0.3,99.7
8,1,1,2,-5,502,518,16,3.1,96.9
8,1,1,2,-4,741,758,17,2.2,97.8
8,1,1,2,-3,867,933,66,7.1,92.9
8,1,1,2,-2,924,1111,187,16.8,83.2
8,1,1,2,-1,1487,2251,764,33.9,66.1
8,1,1,2,0,944,2855,1911,66.9,33.1
8,1,1,2,1,254,2494,2240,89.8,10.2
8,1,1,2,2,91,2097,2006,95.7,4.3
8,1,1,2,3,26,1618,1592,98.4,1.59999999999999
8,1,1,2,4,6,1220,1214,99.5,0.5
8,1,1,2,5,3,771,768,99.6,0.400000000000006
8,1,1,2,6,0,533,533,100,0
8,1,1,2,7,0,335,335,100,0
8,1,1,2,8,0,217,217,100,0
8,1,1,2,9,0,139,139,100,0
8,1,1,2,10,0,90,90,100,0
8,1,1,2,11,0,75,75,100,0
8,1,1,2,12,0,42,42,100,0
8,1,1,2,13,0,18,18,100,0
8,1,1,2,14,0,12,12,100,0
8,1,1,2,15,0,5,5,100,0
8,1,1,2,16,0,9,9,100,0
8,1,1,2,17,0,3,3,100,0
8,1,1,2,20,0,1,1,100,0
8,1,1,12,-19,1,1,0,0,100
8,1,1,12,-17,1,1,0,0,100
8,1,1,12,-16,2,2,0,0,100
8,1,1,12,-15,8,8,0,0,100
8,1,1,12,-14,10,10,0,0,100
8,1,1,12,-13,17,17,0,0,100
8,1,1,12,-12,30,30,0,0,100
8,1,1,12,-11,45,45,0,0,100
8,1,1,12,-10,85,85,0,0,100
8,1,1,12,-9,121,121,0,0,100
8,1,1,12,-8,184,184,0,0,100
8,1,1,12,-7,306,307,1,0.3,99.7
8,1,1,12,-6,411,417,6,1.4,98.6
8,1,1,12,-5,565,581,16,2.8,97.2
8,1,1,12,-4,796,838,42,5,95
8,1,1,12,-3,941,1067,126,11.8,88.2
8,1,1,12,-2,973,1255,282,22.5,77.5
8,1,1,12,-1,895,1467,572,39,61
8,1,1,12,0,657,2073,1416,68.3,31.7
8,1,1,12,1,180,1761,1581,89.8,10.2
8,1,1,12,2,74,1471,1397,95,5
8,1,1,12,3,17,1131,1114,98.5,1.5
8,1,1,12,4,3,888,885,99.7,0.299999999999997
8,1,1,12,5,2,686,684,99.7,0.299999999999997
8,1,1,12,6,0,523,523,100,0
8,1,1,12,7,0,405,405,100,0
8,1,1,12,8,0,285,285,100,0
8,1,1,12,9,0,170,170,100,0
8,1,1,12,10,0,128,128,100,0
8,1,1,12,11,0,74,74,100,0
8,1,1,12,12,0,41,41,100,0
8,1,1,12,13,0,20,20,100,0
8,1,1,12,14,0,12,12,100,0
8,1,1,12,15,0,9,9,100,0
8,1,1,12,16,0,9,9,100,0
8,1,1,12,17,0,4,4,100,0
8,1,1,12,18,0,1,1,100,0
8,1,1,12,19,0,1,1,100,0
8,1,1,12,21,0,1,1,100,0
8,1,1,3,-19,1,1,0,0,100
8,1,1,3,-14,5,5,0,0,100
8,1,1,3,-13,1,1,0,0,100
8,1,1,3,-12,6,6,0,0,100
8,1,1,3,-11,10,10,0,0,100
8,1,1,3,-10,18,18,0,0,100
8,1,1,3,-9,21,21,0,0,100
8,1,1,3,-8,46,46,0,0,100
8,1,1,3,-7,50,50,0,0,100
8,1,1,3,-6,110,110,0,0,100
8,1,1,3,-5,144,145,1,0.7,99.3
8,1,1,3,-4,189,200,11,5.5,94.5
8,1,1,3,-3,234,251,17,6.8,93.2
8,1,1,3,-2,290,376,86,22.9,77.1
8,1,1,3,-1,342,604,262,43.4,56.6
8,1,1,3,0,198,733,535,73,27
8,1,1,3,1,65,737,672,91.2,8.8
8,1,1,3,2,28,705,677,96,4
8,1,1,3,3,10,577,567,98.3,1.7
8,1,1,3,4,3,450,447,99.3,0.700000000000003
8,1,1,3,5,1,286,285,99.7,0.299999999999997
8,1,1,3,6,0,176,176,100,0
8,1,1,3,7,0,129,129,100,0
8,1,1,3,8,0,81,81,100,0
8,1,1,3,9,0,49,49,100,0
8,1,1,3,10,0,23,23,100,0
8,1,1,3,11,0,24,24,100,0
8,1,1,3,12,0,17,17,100,0
8,1,1,3,13,0,6,6,100,0
8,1,1,3,14,0,3,3,100,0
8,1,1,3,15,0,2,2,100,0
8,1,1,3,16,0,2,2,100,0
8,1,1,3,18,0,4,4,100,0
8,1,1,13,-15,3,3,0,0,100
8,1,1,13,-14,3,3,0,0,100
8,1,1,13,-13,7,7,0,0,100
8,1,1,13,-12,6,6,0,0,100
8,1,1,13,-11,21,21,0,0,100
8,1,1,13,-10,21,21,0,0,100
8,1,1,13,-9,41,41,0,0,100
8,1,1,13,-8,76,76,0,0,100
8,1,1,13,-7,118,118,0,0,100
8,1,1,13,-6,135,137,2,1.5,98.5
8,1,1,13,-5,224,229,5,2.2,97.8
8,1,1,13,-4,307,327,20,6.1,93.9
8,1,1,13,-3,333,379,46,12.1,87.9
8,1,1,13,-2,371,517,146,28.2,71.8
8,1,1,13,-1,383,687,304,44.3,55.7
8,1,1,13,0,223,873,650,74.5,25.5
8,1,1,13,1,58,818,760,92.9,7.09999999999999
8,1,1,13,2,17,698,681,97.6,2.40000000000001
8,1,1,13,3,9,554,545,98.4,1.59999999999999
8,1,1,13,4,5,451,446,98.9,1.09999999999999
8,1,1,13,5,0,346,346,100,0
8,1,1,13,6,1,212,211,99.5,0.5
8,1,1,13,7,0,121,121,100,0
8,1,1,13,8,0,114,114,100,0
8,1,1,13,9,0,72,72,100,0
8,1,1,13,10,0,57,57,100,0
8,1,1,13,11,0,33,33,100,0
8,1,1,13,12,0,18,18,100,0
8,1,1,13,13,0,10,10,100,0
8,1,1,13,14,0,6,6,100,0
8,1,1,13,15,0,2,2,100,0
8,1,1,13,16,0,3,3,100,0
8,1,1,13,17,0,2,2,100,0
8,1,1,13,18,0,1,1,100,0
8,1,1,23,-20,1,1,0,0,100
8,1,1,23,-14,5,5,0,0,100
8,1,1,23,-13,1,1,0,0,100
8,1,1,23,-12,10,10,0,0,100
8,1,1,23,-11,13,13,0,0,100
8,1,1,23,-10,24,24,0,0,100
8,1,1,23,-9,20,20,0,0,100
8,1,1,23,-8,44,44,0,0,100
8,1,1,23,-7,75,76,1,1.3,98.7
8,1,1,23,-6,86,86,0,0,100
8,1,1,23,-5,132,138,6,4.3,95.7
8,1,1,23,-4,143,157,14,8.9,91.1
8,1,1,23,-3,231,271,40,14.8,85.2
8,1,1,23,-2,355,522,167,32,68
8,1,1,23,-1,214,483,269,55.7,44.3
8,1,1,23,0,130,594,464,78.1,21.9
8,1,1,23,1,39,571,532,93.2,6.8
8,1,1,23,2,22,557,535,96.1,3.90000000000001
8,1,1,23,3,6,489,483,98.8,1.2
8,1,1,23,4,2,366,364,99.5,0.5
8,1,1,23,5,1,266,265,99.6,0.400000000000006
8,1,1,23,6,0,178,178,100,0
8,1,1,23,7,0,150,150,100,0
8,1,1,23,8,0,94,94,100,0
8,1,1,23,9,0,70,70,100,0
8,1,1,23,10,0,24,24,100,0
8,1,1,23,11,0,23,23,100,0
8,1,1,23,12,0,19,19,100,0
8,1,1,23,13,0,8,8,100,0
8,1,1,23,14,0,4,4,100,0
8,1,1,23,15,0,3,3,100,0
8,1,1,23,16,0,1,1,100,0
8,1,1,23,17,0,1,1,100,0
8,1,1,23,21,0,1,1,100,0
8,1,1,123,-22,1,1,0,0,100
8,1,1,123,-15,1,1,0,0,100
8,1,1,123,-14,3,3,0,0,100
8,1,1,123,-13,6,6,0,0,100
8,1,1,123,-12,3,3,0,0,100
8,1,1,123,-11,16,16,0,0,100
8,1,1,123,-10,20,20,0,0,100
8,1,1,123,-9,27,27,0,0,100
8,1,1,123,-8,47,47,0,0,100
8,1,1,123,-7,79,80,1,1.2,98.8
8,1,1,123,-6,115,120,5,4.2,95.8
8,1,1,123,-5,173,186,13,7,93
8,1,1,123,-4,178,201,23,11.4,88.6
8,1,1,123,-3,206,252,46,18.3,81.7
8,1,1,123,-2,243,369,126,34.1,65.9
8,1,1,123,-1,262,591,329,55.7,44.3
8,1,1,123,0,197,877,680,77.5,22.5
8,1,1,123,1,53,811,758,93.5,6.5
8,1,1,123,2,21,683,662,96.9,3.10000000000001
8,1,1,123,3,5,511,506,99,1
8,1,1,123,4,3,426,423,99.3,0.700000000000003
8,1,1,123,5,0,303,303,100,0
8,1,1,123,6,0,190,190,100,0
8,1,1,123,7,0,114,114,100,0
8,1,1,123,8,0,100,100,100,0
8,1,1,123,9,0,57,57,100,0
8,1,1,123,10,0,43,43,100,0
8,1,1,123,11,0,22,22,100,0
8,1,1,123,12,0,15,15,100,0
8,1,1,123,13,0,6,6,100,0
8,1,1,123,14,0,3,3,100,0
8,1,1,123,15,0,4,4,100,0
8,1,1,123,16,0,2,2,100,0
8,1,1,123,17,0,2,2,100,0
8,1,1,123,19,0,1,1,100,0
8,1,2,0,-25,1,1,0,0,100
8,1,2,0,-22,2,2,0,0,100
8,1,2,0,-21,2,2,0,0,100
8,1,2,0,-20,1,1,0,0,100
8,1,2,0,-19,3,3,0,0,100
8,1,2,0,-18,5,5,0,0,100
8,1,2,0,-17,9,9,0,0,100
8,1,2,0,-16,13,13,0,0,100
8,1,2,0,-15,23,23,0,0,100
8,1,2,0,-14,56,56,0,0,100
8,1,2,0,-13,86,86,0,0,100
8,1,2,0,-12,128,128,0,0,100
8,1,2,0,-11,234,234,0,0,100
8,1,2,0,-10,356,356,0,0,100
8,1,2,0,-9,581,581,0,0,100
8,1,2,0,-8,862,862,0,0,100
8,1,2,0,-7,1340,1343,3,0.2,99.8
8,1,2,0,-6,1984,1988,4,0.2,99.8
8,1,2,0,-5,2837,2853,16,0.6,99.4
8,1,2,0,-4,3864,3925,61,1.6,98.4
8,1,2,0,-3,5117,5262,145,2.8,97.2
8,1,2,0,-2,6057,6567,510,7.8,92.2
8,1,2,0,-1,6157,7446,1289,17.3,82.7
8,1,2,0,0,3772,7778,4006,51.5,48.5
8,1,2,0,1,1102,7740,6638,85.8,14.2
8,1,2,0,2,335,6564,6229,94.9,5.10000000000001
8,1,2,0,3,108,5446,5338,98,2
8,1,2,0,4,43,4257,4214,99,1
8,1,2,0,5,12,3127,3115,99.6,0.400000000000006
8,1,2,0,6,3,2167,2164,99.9,0.0999999999999943
8,1,2,0,7,0,1410,1410,100,0
8,1,2,0,8,0,1055,1055,100,0
8,1,2,0,9,0,747,747,100,0
8,1,2,0,10,0,489,489,100,0
8,1,2,0,11,0,281,281,100,0
8,1,2,0,12,0,164,164,100,0
8,1,2,0,13,0,98,98,100,0
8,1,2,0,14,0,67,67,100,0
8,1,2,0,15,0,31,31,100,0
8,1,2,0,16,0,19,19,100,0
8,1,2,0,17,0,12,12,100,0
8,1,2,0,18,0,6,6,100,0
8,1,2,0,19,0,5,5,100,0
8,1,2,0,21,0,2,2,100,0
8,1,2,0,22,0,1,1,100,0
8,1,2,0,26,0,1,1,100,0
8,1,2,1,-23,1,1,0,0,100
8,1,2,1,-22,2,2,0,0,100
8,1,2,1,-21,1,1,0,0,100
8,1,2,1,-19,4,4,0,0,100
8,1,2,1,-18,4,4,0,0,100
8,1,2,1,-17,5,5,0,0,100
8,1,2,1,-16,14,14,0,0,100
8,1,2,1,-15,13,13,0,0,100
8,1,2,1,-14,32,32,0,0,100
8,1,2,1,-13,51,51,0,0,100
8,1,2,1,-12,78,78,0,0,100
8,1,2,1,-11,137,137,0,0,100
8,1,2,1,-10,205,205,0,0,100
8,1,2,1,-9,326,326,0,0,100
8,1,2,1,-8,496,496,0,0,100
8,1,2,1,-7,770,771,1,0.1,99.9
8,1,2,1,-6,1124,1129,5,0.4,99.6
8,1,2,1,-5,1595,1609,14,0.9,99.1
8,1,2,1,-4,2138,2189,51,2.3,97.7
8,1,2,1,-3,2734,2851,117,4.1,95.9
8,1,2,1,-2,3339,3705,366,9.9,90.1
8,1,2,1,-1,3184,4075,891,21.9,78.1
8,1,2,1,0,1953,4282,2329,54.4,45.6
8,1,2,1,1,493,3757,3264,86.9,13.1
8,1,2,1,2,203,3513,3310,94.2,5.80000000000001
8,1,2,1,3,53,2938,2885,98.2,1.8
8,1,2,1,4,21,2386,2365,99.1,0.900000000000006
8,1,2,1,5,3,1900,1897,99.8,0.200000000000003
8,1,2,1,6,1,1405,1404,99.9,0.0999999999999943
8,1,2,1,7,0,921,921,100,0
8,1,2,1,8,1,723,722,99.9,0.0999999999999943
8,1,2,1,9,0,442,442,100,0
8,1,2,1,10,0,320,320,100,0
8,1,2,1,11,0,193,193,100,0
8,1,2,1,12,0,118,118,100,0
8,1,2,1,13,0,65,65,100,0
8,1,2,1,14,0,39,39,100,0
8,1,2,1,15,0,28,28,100,0
8,1,2,1,16,0,11,11,100,0
8,1,2,1,17,0,6,6,100,0
8,1,2,1,18,0,6,6,100,0
8,1,2,1,19,0,5,5,100,0
8,1,2,1,20,0,3,3,100,0
8,1,2,1,21,0,2,2,100,0
8,1,2,1,22,0,1,1,100,0
8,1,2,1,26,0,1,1,100,0
8,1,2,2,-19,1,1,0,0,100
8,1,2,2,-18,1,1,0,0,100
8,1,2,2,-17,3,3,0,0,100
8,1,2,2,-16,3,3,0,0,100
8,1,2,2,-15,7,7,0,0,100
8,1,2,2,-14,17,17,0,0,100
8,1,2,2,-13,19,19,0,0,100
8,1,2,2,-12,30,30,0,0,100
8,1,2,2,-11,64,64,0,0,100
8,1,2,2,-10,84,84,0,0,100
8,1,2,2,-9,139,139,0,0,100
8,1,2,2,-8,224,224,0,0,100
8,1,2,2,-7,313,313,0,0,100
8,1,2,2,-6,447,448,1,0.2,99.8
8,1,2,2,-5,638,644,6,0.9,99.1
8,1,2,2,-4,884,898,14,1.6,98.4
8,1,2,2,-3,1182,1237,55,4.4,95.6
8,1,2,2,-2,1278,1441,163,11.3,88.7
8,1,2,2,-1,1704,2243,539,24,76
8,1,2,2,0,1010,2446,1436,58.7,41.3
8,1,2,2,1,296,2453,2157,87.9,12.1
8,1,2,2,2,128,2289,2161,94.4,5.60000000000001
8,1,2,2,3,41,1948,1907,97.9,2.10000000000001
8,1,2,2,4,11,1559,1548,99.3,0.700000000000003
8,1,2,2,5,4,1044,1040,99.6,0.400000000000006
8,1,2,2,6,0,728,728,100,0
8,1,2,2,7,0,467,467,100,0
8,1,2,2,8,0,329,329,100,0
8,1,2,2,9,0,198,198,100,0
8,1,2,2,10,0,139,139,100,0
8,1,2,2,11,0,82,82,100,0
8,1,2,2,12,0,75,75,100,0
8,1,2,2,13,0,33,33,100,0
8,1,2,2,14,0,25,25,100,0
8,1,2,2,15,0,18,18,100,0
8,1,2,2,16,0,12,12,100,0
8,1,2,2,17,0,4,4,100,0
8,1,2,2,18,0,1,1,100,0
8,1,2,2,19,0,2,2,100,0
8,1,2,2,20,0,1,1,100,0
8,1,2,12,-21,2,2,0,0,100
8,1,2,12,-19,1,1,0,0,100
8,1,2,12,-18,2,2,0,0,100
8,1,2,12,-17,2,2,0,0,100
8,1,2,12,-16,2,2,0,0,100
8,1,2,12,-15,2,2,0,0,100
8,1,2,12,-14,13,13,0,0,100
8,1,2,12,-13,19,19,0,0,100
8,1,2,12,-12,42,42,0,0,100
8,1,2,12,-11,50,50,0,0,100
8,1,2,12,-10,80,80,0,0,100
8,1,2,12,-9,132,132,0,0,100
8,1,2,12,-8,196,196,0,0,100
8,1,2,12,-7,338,339,1,0.3,99.7
8,1,2,12,-6,486,487,1,0.2,99.8
8,1,2,12,-5,599,608,9,1.5,98.5
8,1,2,12,-4,929,971,42,4.3,95.7
8,1,2,12,-3,1198,1278,80,6.3,93.7
8,1,2,12,-2,1356,1572,216,13.7,86.3
8,1,2,12,-1,1359,1878,519,27.6,72.4
8,1,2,12,0,1027,2564,1537,59.9,40.1
8,1,2,12,1,267,2342,2075,88.6,11.4
8,1,2,12,2,115,1991,1876,94.2,5.80000000000001
8,1,2,12,3,24,1694,1670,98.6,1.40000000000001
8,1,2,12,4,6,1326,1320,99.5,0.5
8,1,2,12,5,1,978,977,99.9,0.0999999999999943
8,1,2,12,6,1,775,774,99.9,0.0999999999999943
8,1,2,12,7,0,548,548,100,0
8,1,2,12,8,0,350,350,100,0
8,1,2,12,9,0,243,243,100,0
8,1,2,12,10,0,185,185,100,0
8,1,2,12,11,0,108,108,100,0
8,1,2,12,12,0,58,58,100,0
8,1,2,12,13,0,37,37,100,0
8,1,2,12,14,0,15,15,100,0
8,1,2,12,15,0,19,19,100,0
8,1,2,12,16,0,8,8,100,0
8,1,2,12,17,0,6,6,100,0
8,1,2,12,18,0,7,7,100,0
8,1,2,12,19,0,3,3,100,0
8,1,2,3,-18,1,1,0,0,100
8,1,2,3,-16,3,3,0,0,100
8,1,2,3,-15,4,4,0,0,100
8,1,2,3,-14,9,9,0,0,100
8,1,2,3,-13,5,5,0,0,100
8,1,2,3,-12,8,8,0,0,100
8,1,2,3,-11,14,14,0,0,100
8,1,2,3,-10,35,35,0,0,100
8,1,2,3,-9,48,48,0,0,100
8,1,2,3,-8,76,76,0,0,100
8,1,2,3,-7,90,91,1,1.1,98.9
8,1,2,3,-6,156,157,1,0.6,99.4
8,1,2,3,-5,234,236,2,0.8,99.2
8,1,2,3,-4,337,341,4,1.2,98.8
8,1,2,3,-3,436,458,22,4.8,95.2
8,1,2,3,-2,461,520,59,11.3,88.7
8,1,2,3,-1,713,958,245,25.6,74.4
8,1,2,3,0,368,918,550,59.9,40.1
8,1,2,3,1,99,899,800,89,11
8,1,2,3,2,56,901,845,93.8,6.2
8,1,2,3,3,10,776,766,98.7,1.3
8,1,2,3,4,3,585,582,99.5,0.5
8,1,2,3,5,1,451,450,99.8,0.200000000000003
8,1,2,3,6,0,312,312,100,0
8,1,2,3,7,0,225,225,100,0
8,1,2,3,8,0,148,148,100,0
8,1,2,3,9,0,102,102,100,0
8,1,2,3,10,0,45,45,100,0
8,1,2,3,11,0,41,41,100,0
8,1,2,3,12,0,31,31,100,0
8,1,2,3,13,0,13,13,100,0
8,1,2,3,14,0,5,5,100,0
8,1,2,3,15,0,8,8,100,0
8,1,2,3,16,0,3,3,100,0
8,1,2,3,17,0,2,2,100,0
8,1,2,3,18,0,3,3,100,0
8,1,2,3,22,0,1,1,100,0
8,1,2,13,-19,2,2,0,0,100
8,1,2,13,-15,4,4,0,0,100
8,1,2,13,-14,5,5,0,0,100
8,1,2,13,-13,12,12,0,0,100
8,1,2,13,-12,14,14,0,0,100
8,1,2,13,-11,17,17,0,0,100
8,1,2,13,-10,37,37,0,0,100
8,1,2,13,-9,44,44,0,0,100
8,1,2,13,-8,63,63,0,0,100
8,1,2,13,-7,116,116,0,0,100
8,1,2,13,-6,187,187,0,0,100
8,1,2,13,-5,284,287,3,1,99
8,1,2,13,-4,384,398,14,3.5,96.5
8,1,2,13,-3,498,536,38,7.1,92.9
8,1,2,13,-2,558,651,93,14.3,85.7
8,1,2,13,-1,675,941,266,28.3,71.7
8,1,2,13,0,428,1124,696,61.9,38.1
8,1,2,13,1,128,1052,924,87.8,12.2
8,1,2,13,2,45,974,929,95.4,4.60000000000001
8,1,2,13,3,14,758,744,98.2,1.8
8,1,2,13,4,6,589,583,99,1
8,1,2,13,5,0,487,487,100,0
8,1,2,13,6,1,353,352,99.7,0.299999999999997
8,1,2,13,7,0,232,232,100,0
8,1,2,13,8,0,155,155,100,0
8,1,2,13,9,0,100,100,100,0
8,1,2,13,10,0,82,82,100,0
8,1,2,13,11,0,43,43,100,0
8,1,2,13,12,0,40,40,100,0
8,1,2,13,13,0,15,15,100,0
8,1,2,13,14,0,5,5,100,0
8,1,2,13,15,0,7,7,100,0
8,1,2,13,16,0,4,4,100,0
8,1,2,13,17,0,2,2,100,0
8,1,2,13,18,0,2,2,100,0
8,1,2,13,20,0,1,1,100,0
8,1,2,13,22,0,1,1,100,0
8,1,2,23,-20,1,1,0,0,100
8,1,2,23,-17,1,1,0,0,100
8,1,2,23,-16,1,1,0,0,100
8,1,2,23,-15,1,1,0,0,100
8,1,2,23,-14,3,3,0,0,100
8,1,2,23,-13,3,3,0,0,100
8,1,2,23,-12,18,18,0,0,100
8,1,2,23,-11,17,17,0,0,100
8,1,2,23,-10,17,17,0,0,100
8,1,2,23,-9,32,32,0,0,100
8,1,2,23,-8,51,51,0,0,100
8,1,2,23,-7,84,84,0,0,100
8,1,2,23,-6,112,112,0,0,100
8,1,2,23,-5,153,159,6,3.8,96.2
8,1,2,23,-4,221,232,11,4.7,95.3
8,1,2,23,-3,302,328,26,7.9,92.1
8,1,2,23,-2,354,436,82,18.8,81.2
8,1,2,23,-1,288,417,129,30.9,69.1
8,1,2,23,0,213,566,353,62.4,37.6
8,1,2,23,1,59,630,571,90.6,9.39999999999999
8,1,2,23,2,42,629,587,93.3,6.69999999999999
8,1,2,23,3,4,503,499,99.2,0.799999999999997
8,1,2,23,4,7,408,401,98.3,1.7
8,1,2,23,5,1,296,295,99.7,0.299999999999997
8,1,2,23,6,0,201,201,100,0
8,1,2,23,7,0,167,167,100,0
8,1,2,23,8,0,106,106,100,0
8,1,2,23,9,0,70,70,100,0
8,1,2,23,10,0,48,48,100,0
8,1,2,23,11,0,38,38,100,0
8,1,2,23,12,0,24,24,100,0
8,1,2,23,13,0,12,12,100,0
8,1,2,23,14,0,6,6,100,0
8,1,2,23,15,0,6,6,100,0
8,1,2,23,16,0,3,3,100,0
8,1,2,23,17,0,1,1,100,0
8,1,2,23,18,0,1,1,100,0
8,1,2,23,20,0,1,1,100,0
8,1,2,123,-21,1,1,0,0,100
8,1,2,123,-16,1,1,0,0,100
8,1,2,123,-14,5,5,0,0,100
8,1,2,123,-13,7,7,0,0,100
8,1,2,123,-12,8,8,0,0,100
8,1,2,123,-11,14,14,0,0,100
8,1,2,123,-10,25,25,0,0,100
8,1,2,123,-9,38,38,0,0,100
8,1,2,123,-8,56,56,0,0,100
8,1,2,123,-7,98,99,1,1,99
8,1,2,123,-6,134,135,1,0.7,99.3
8,1,2,123,-5,186,194,8,4.1,95.9
8,1,2,123,-4,253,274,21,7.7,92.3
8,1,2,123,-3,316,352,36,10.2,89.8
8,1,2,123,-2,387,486,99,20.4,79.6
8,1,2,123,-1,460,725,265,36.6,63.4
8,1,2,123,0,352,1016,664,65.4,34.6
8,1,2,123,1,76,955,879,92,8
8,1,2,123,2,40,857,817,95.3,4.7
8,1,2,123,3,9,647,638,98.6,1.40000000000001
8,1,2,123,4,5,520,515,99,1
8,1,2,123,5,2,380,378,99.5,0.5
8,1,2,123,6,1,265,264,99.6,0.400000000000006
8,1,2,123,7,0,185,185,100,0
8,1,2,123,8,0,129,129,100,0
8,1,2,123,9,0,91,91,100,0
8,1,2,123,10,0,69,69,100,0
8,1,2,123,11,0,39,39,100,0
8,1,2,123,12,0,16,16,100,0
8,1,2,123,13,0,15,15,100,0
8,1,2,123,14,0,6,6,100,0
8,1,2,123,15,0,9,9,100,0
8,1,2,123,16,0,3,3,100,0
8,1,2,123,17,0,1,1,100,0
8,1,2,123,18,0,2,2,100,0
8,1,2,123,19,0,1,1,100,0
9,0,0,0,-25,1,1,0,0,100
9,0,0,0,-23,1,1,0,0,100
9,0,0,0,-22,3,3,0,0,100
9,0,0,0,-21,4,4,0,0,100
9,0,0,0,-20,1,1,0,0,100
9,0,0,0,-19,8,8,0,0,100
9,0,0,0,-18,9,9,0,0,100
9,0,0,0,-17,14,14,0,0,100
9,0,0,0,-16,32,32,0,0,100
9,0,0,0,-15,38,38,0,0,100
9,0,0,0,-14,98,98,0,0,100
9,0,0,0,-13,151,151,0,0,100
9,0,0,0,-12,243,243,0,0,100
9,0,0,0,-11,407,407,0,0,100
9,0,0,0,-10,644,644,0,0,100
9,0,0,0,-9,1009,1009,0,0,100
9,0,0,0,-8,1519,1519,0,0,100
9,0,0,0,-7,2391,2393,2,0.1,99.9
9,0,0,0,-6,3444,3451,7,0.2,99.8
9,0,0,0,-5,4825,4852,27,0.6,99.4
9,0,0,0,-4,6754,6825,71,1,99
9,0,0,0,-3,8843,9069,226,2.5,97.5
9,0,0,0,-2,10571,11287,716,6.3,93.7
9,0,0,0,-1,11435,13337,1902,14.3,85.7
9,0,0,0,0,7187,13993,6806,48.6,51.4
9,0,0,0,1,1966,13784,11818,85.7,14.3
9,0,0,0,2,732,12245,11513,94,6
9,0,0,0,3,221,10125,9904,97.8,2.2
9,0,0,0,4,84,8124,8040,99,1
9,0,0,0,5,23,6148,6125,99.6,0.400000000000006
9,0,0,0,6,5,4391,4386,99.9,0.0999999999999943
9,0,0,0,7,0,2938,2938,100,0
9,0,0,0,8,1,2140,2139,100,0
9,0,0,0,9,0,1480,1480,100,0
9,0,0,0,10,0,969,969,100,0
9,0,0,0,11,0,596,596,100,0
9,0,0,0,12,0,394,394,100,0
9,0,0,0,13,0,210,210,100,0
9,0,0,0,14,0,120,120,100,0
9,0,0,0,15,0,69,69,100,0
9,0,0,0,16,0,49,49,100,0
9,0,0,0,17,0,25,25,100,0
9,0,0,0,18,0,16,16,100,0
9,0,0,0,19,0,14,14,100,0
9,0,0,0,20,0,5,5,100,0
9,0,0,0,21,0,3,3,100,0
9,0,0,0,22,0,2,2,100,0
9,0,0,0,26,0,1,1,100,0
9,0,0,1,-22,1,1,0,0,100
9,0,0,1,-21,2,2,0,0,100
9,0,0,1,-19,4,4,0,0,100
9,0,0,1,-17,3,3,0,0,100
9,0,0,1,-16,9,9,0,0,100
9,0,0,1,-15,5,5,0,0,100
9,0,0,1,-14,20,20,0,0,100
9,0,0,1,-13,40,40,0,0,100
9,0,0,1,-12,70,70,0,0,100
9,0,0,1,-11,122,122,0,0,100
9,0,0,1,-10,197,197,0,0,100
9,0,0,1,-9,235,235,0,0,100
9,0,0,1,-8,393,393,0,0,100
9,0,0,1,-7,625,625,0,0,100
9,0,0,1,-6,889,891,2,0.2,99.8
9,0,0,1,-5,1306,1314,8,0.6,99.4
9,0,0,1,-4,1756,1767,11,0.6,99.4
9,0,0,1,-3,2273,2330,57,2.4,97.6
9,0,0,1,-2,2577,2727,150,5.5,94.5
9,0,0,1,-1,2904,3322,418,12.6,87.4
9,0,0,1,0,2202,3716,1514,40.7,59.3
9,0,0,1,1,908,3471,2563,73.8,26.2
9,0,0,1,2,392,3032,2640,87.1,12.9
9,0,0,1,3,126,2424,2298,94.8,5.2
9,0,0,1,4,58,1997,1939,97.1,2.90000000000001
9,0,0,1,5,14,1535,1521,99.1,0.900000000000006
9,0,0,1,6,4,1115,1111,99.6,0.400000000000006
9,0,0,1,7,0,708,708,100,0
9,0,0,1,8,1,497,496,99.8,0.200000000000003
9,0,0,1,9,0,357,357,100,0
9,0,0,1,10,0,257,257,100,0
9,0,0,1,11,0,127,127,100,0
9,0,0,1,12,0,104,104,100,0
9,0,0,1,13,0,46,46,100,0
9,0,0,1,14,0,28,28,100,0
9,0,0,1,15,0,17,17,100,0
9,0,0,1,16,0,11,11,100,0
9,0,0,1,17,0,3,3,100,0
9,0,0,1,18,0,2,2,100,0
9,0,0,1,19,0,4,4,100,0
9,0,0,1,20,0,5,5,100,0
9,0,0,1,21,0,1,1,100,0
9,0,0,1,22,0,1,1,100,0
9,0,0,1,26,0,1,1,100,0
9,0,0,2,-17,1,1,0,0,100
9,0,0,2,-16,1,1,0,0,100
9,0,0,2,-15,8,8,0,0,100
9,0,0,2,-14,8,8,0,0,100
9,0,0,2,-13,15,15,0,0,100
9,0,0,2,-12,17,17,0,0,100
9,0,0,2,-11,38,38,0,0,100
9,0,0,2,-10,36,36,0,0,100
9,0,0,2,-9,79,79,0,0,100
9,0,0,2,-8,114,114,0,0,100
9,0,0,2,-7,187,187,0,0,100
9,0,0,2,-6,256,257,1,0.4,99.6
9,0,0,2,-5,350,352,2,0.6,99.4
9,0,0,2,-4,574,577,3,0.5,99.5
9,0,0,2,-3,664,674,10,1.5,98.5
9,0,0,2,-2,794,822,28,3.4,96.6
9,0,0,2,-1,774,863,89,10.3,89.7
9,0,0,2,0,579,851,272,32,68
9,0,0,2,1,252,729,477,65.4,34.6
9,0,0,2,2,102,677,575,84.9,15.1
9,0,0,2,3,36,588,552,93.9,6.10000000000001
9,0,0,2,4,9,488,479,98.2,1.8
9,0,0,2,5,4,346,342,98.8,1.2
9,0,0,2,6,0,242,242,100,0
9,0,0,2,7,0,171,171,100,0
9,0,0,2,8,0,132,132,100,0
9,0,0,2,9,0,96,96,100,0
9,0,0,2,10,0,45,45,100,0
9,0,0,2,11,0,38,38,100,0
9,0,0,2,12,0,19,19,100,0
9,0,0,2,13,0,16,16,100,0
9,0,0,2,14,0,7,7,100,0
9,0,0,2,15,0,4,4,100,0
9,0,0,2,16,0,2,2,100,0
9,0,0,2,17,0,2,2,100,0
9,0,0,2,19,0,1,1,100,0
9,0,0,2,21,0,1,1,100,0
9,0,0,12,-21,1,1,0,0,100
9,0,0,12,-19,1,1,0,0,100
9,0,0,12,-17,1,1,0,0,100
9,0,0,12,-16,2,2,0,0,100
9,0,0,12,-15,4,4,0,0,100
9,0,0,12,-14,9,9,0,0,100
9,0,0,12,-13,13,13,0,0,100
9,0,0,12,-12,18,18,0,0,100
9,0,0,12,-11,35,35,0,0,100
9,0,0,12,-10,63,63,0,0,100
9,0,0,12,-9,76,76,0,0,100
9,0,0,12,-8,123,123,0,0,100
9,0,0,12,-7,157,157,0,0,100
9,0,0,12,-6,234,235,1,0.4,99.6
9,0,0,12,-5,353,354,1,0.3,99.7
9,0,0,12,-4,412,414,2,0.5,99.5
9,0,0,12,-3,514,524,10,1.9,98.1
9,0,0,12,-2,502,523,21,4,96
9,0,0,12,-1,528,582,54,9.3,90.7
9,0,0,12,0,395,566,171,30.2,69.8
9,0,0,12,1,305,670,365,54.5,45.5
9,0,0,12,2,186,731,545,74.6,25.4
9,0,0,12,3,67,604,537,88.9,11.1
9,0,0,12,4,32,457,425,93,7
9,0,0,12,5,10,359,349,97.2,2.8
9,0,0,12,6,4,276,272,98.6,1.40000000000001
9,0,0,12,7,0,180,180,100,0
9,0,0,12,8,0,124,124,100,0
9,0,0,12,9,0,75,75,100,0
9,0,0,12,10,0,63,63,100,0
9,0,0,12,11,0,28,28,100,0
9,0,0,12,12,0,29,29,100,0
9,0,0,12,13,0,10,10,100,0
9,0,0,12,14,0,7,7,100,0
9,0,0,12,15,0,4,4,100,0
9,0,0,12,16,0,1,1,100,0
9,0,0,12,17,0,2,2,100,0
9,0,0,12,19,0,1,1,100,0
9,0,0,12,20,0,2,2,100,0
9,0,0,12,22,0,1,1,100,0
9,0,0,3,-15,1,1,0,0,100
9,0,0,3,-14,2,2,0,0,100
9,0,0,3,-13,4,4,0,0,100
9,0,0,3,-12,4,4,0,0,100
9,0,0,3,-11,5,5,0,0,100
9,0,0,3,-10,12,12,0,0,100
9,0,0,3,-9,16,16,0,0,100
9,0,0,3,-8,21,21,0,0,100
9,0,0,3,-7,38,38,0,0,100
9,0,0,3,-6,53,53,0,0,100
9,0,0,3,-5,74,74,0,0,100
9,0,0,3,-4,110,112,2,1.8,98.2
9,0,0,3,-3,137,139,2,1.4,98.6
9,0,0,3,-2,178,183,5,2.7,97.3
9,0,0,3,-1,155,163,8,4.9,95.1
9,0,0,3,0,135,174,39,22.4,77.6
9,0,0,3,1,46,123,77,62.6,37.4
9,0,0,3,2,11,95,84,88.4,11.6
9,0,0,3,3,5,77,72,93.5,6.5
9,0,0,3,4,1,64,63,98.4,1.59999999999999
9,0,0,3,5,0,44,44,100,0
9,0,0,3,6,0,43,43,100,0
9,0,0,3,7,0,24,24,100,0
9,0,0,3,8,0,19,19,100,0
9,0,0,3,9,0,10,10,100,0
9,0,0,3,10,0,6,6,100,0
9,0,0,3,11,0,9,9,100,0
9,0,0,3,12,0,1,1,100,0
9,0,0,3,13,0,3,3,100,0
9,0,0,3,14,0,4,4,100,0
9,0,0,3,15,0,1,1,100,0
9,0,0,13,-16,1,1,0,0,100
9,0,0,13,-15,1,1,0,0,100
9,0,0,13,-13,7,7,0,0,100
9,0,0,13,-12,7,7,0,0,100
9,0,0,13,-11,8,8,0,0,100
9,0,0,13,-10,12,12,0,0,100
9,0,0,13,-9,21,21,0,0,100
9,0,0,13,-8,34,34,0,0,100
9,0,0,13,-7,68,68,0,0,100
9,0,0,13,-6,98,98,0,0,100
9,0,0,13,-5,114,114,0,0,100
9,0,0,13,-4,179,180,1,0.6,99.4
9,0,0,13,-3,210,214,4,1.9,98.1
9,0,0,13,-2,235,243,8,3.3,96.7
9,0,0,13,-1,281,311,30,9.6,90.4
9,0,0,13,0,219,272,53,19.5,80.5
9,0,0,13,1,169,303,134,44.2,55.8
9,0,0,13,2,49,219,170,77.6,22.4
9,0,0,13,3,16,152,136,89.5,10.5
9,0,0,13,4,11,107,96,89.7,10.3
9,0,0,13,5,0,91,91,100,0
9,0,0,13,6,0,62,62,100,0
9,0,0,13,7,1,47,46,97.9,2.10000000000001
9,0,0,13,8,1,35,34,97.1,2.90000000000001
9,0,0,13,9,0,25,25,100,0
9,0,0,13,10,0,10,10,100,0
9,0,0,13,11,0,15,15,100,0
9,0,0,13,12,0,6,6,100,0
9,0,0,13,13,0,3,3,100,0
9,0,0,13,14,0,2,2,100,0
9,0,0,13,15,0,2,2,100,0
9,0,0,13,17,0,1,1,100,0
9,0,0,13,19,0,1,1,100,0
9,0,0,23,-23,1,1,0,0,100
9,0,0,23,-17,2,2,0,0,100
9,0,0,23,-16,1,1,0,0,100
9,0,0,23,-15,1,1,0,0,100
9,0,0,23,-12,7,7,0,0,100
9,0,0,23,-11,8,8,0,0,100
9,0,0,23,-10,13,13,0,0,100
9,0,0,23,-9,21,21,0,0,100
9,0,0,23,-8,32,32,0,0,100
9,0,0,23,-7,41,41,0,0,100
9,0,0,23,-6,66,66,0,0,100
9,0,0,23,-5,74,75,1,1.3,98.7
9,0,0,23,-4,93,93,0,0,100
9,0,0,23,-3,115,117,2,1.7,98.3
9,0,0,23,-2,143,151,8,5.3,94.7
9,0,0,23,-1,133,144,11,7.6,92.4
9,0,0,23,0,109,134,25,18.7,81.3
9,0,0,23,1,78,139,61,43.9,56.1
9,0,0,23,2,35,123,88,71.5,28.5
9,0,0,23,3,13,115,102,88.7,11.3
9,0,0,23,4,3,100,97,97,3
9,0,0,23,5,1,80,79,98.8,1.2
9,0,0,23,6,0,46,46,100,0
9,0,0,23,7,0,36,36,100,0
9,0,0,23,8,0,26,26,100,0
9,0,0,23,9,0,21,21,100,0
9,0,0,23,10,0,19,19,100,0
9,0,0,23,11,0,8,8,100,0
9,0,0,23,12,0,1,1,100,0
9,0,0,23,13,0,2,2,100,0
9,0,0,23,14,0,1,1,100,0
9,0,0,23,21,0,1,1,100,0
9,0,0,23,26,0,1,1,100,0
9,0,0,123,-21,1,1,0,0,100
9,0,0,123,-17,1,1,0,0,100
9,0,0,123,-16,2,2,0,0,100
9,0,0,123,-15,2,2,0,0,100
9,0,0,123,-14,3,3,0,0,100
9,0,0,123,-13,5,5,0,0,100
9,0,0,123,-12,4,4,0,0,100
9,0,0,123,-11,10,10,0,0,100
9,0,0,123,-10,10,10,0,0,100
9,0,0,123,-9,21,21,0,0,100
9,0,0,123,-8,32,32,0,0,100
9,0,0,123,-7,44,44,0,0,100
9,0,0,123,-6,60,60,0,0,100
9,0,0,123,-5,83,83,0,0,100
9,0,0,123,-4,113,114,1,0.9,99.1
9,0,0,123,-3,152,154,2,1.3,98.7
9,0,0,123,-2,155,160,5,3.1,96.9
9,0,0,123,-1,179,189,10,5.3,94.7
9,0,0,123,0,161,189,28,14.8,85.2
9,0,0,123,1,109,172,63,36.6,63.4
9,0,0,123,2,58,145,87,60,40
9,0,0,123,3,33,129,96,74.4,25.6
9,0,0,123,4,16,85,69,81.2,18.8
9,0,0,123,5,2,74,72,97.3,2.7
9,0,0,123,6,1,50,49,98,2
9,0,0,123,7,0,44,44,100,0
9,0,0,123,8,0,18,18,100,0
9,0,0,123,9,0,16,16,100,0
9,0,0,123,10,0,15,15,100,0
9,0,0,123,11,0,7,7,100,0
9,0,0,123,12,0,7,7,100,0
9,0,0,123,13,0,3,3,100,0
9,0,0,123,14,0,2,2,100,0
9,0,1,0,-25,1,1,0,0,100
9,0,1,0,-23,1,1,0,0,100
9,0,1,0,-22,2,2,0,0,100
9,0,1,0,-21,2,2,0,0,100
9,0,1,0,-20,1,1,0,0,100
9,0,1,0,-19,5,5,0,0,100
9,0,1,0,-18,11,11,0,0,100
9,0,1,0,-17,12,12,0,0,100
9,0,1,0,-16,26,26,0,0,100
9,0,1,0,-15,35,35,0,0,100
9,0,1,0,-14,82,82,0,0,100
9,0,1,0,-13,113,113,0,0,100
9,0,1,0,-12,195,195,0,0,100
9,0,1,0,-11,304,304,0,0,100
9,0,1,0,-10,476,476,0,0,100
9,0,1,0,-9,787,787,0,0,100
9,0,1,0,-8,1148,1148,0,0,100
9,0,1,0,-7,1747,1751,4,0.2,99.8
9,0,1,0,-6,2501,2506,5,0.2,99.8
9,0,1,0,-5,3507,3529,22,0.6,99.4
9,0,1,0,-4,4967,5031,64,1.3,98.7
9,0,1,0,-3,6445,6618,173,2.6,97.4
9,0,1,0,-2,7802,8381,579,6.9,93.1
9,0,1,0,-1,8202,9708,1506,15.5,84.5
9,0,1,0,0,4524,9844,5320,54,46
9,0,1,0,1,761,9910,9149,92.3,7.69999999999999
9,0,1,0,2,226,8760,8534,97.4,2.60000000000001
9,0,1,0,3,56,7293,7237,99.2,0.799999999999997
9,0,1,0,4,14,5767,5753,99.8,0.200000000000003
9,0,1,0,5,4,4340,4336,99.9,0.0999999999999943
9,0,1,0,6,0,3035,3035,100,0
9,0,1,0,7,0,2089,2089,100,0
9,0,1,0,8,0,1531,1531,100,0
9,0,1,0,9,0,1025,1025,100,0
9,0,1,0,10,0,671,671,100,0
9,0,1,0,11,0,428,428,100,0
9,0,1,0,12,0,263,263,100,0
9,0,1,0,13,0,149,149,100,0
9,0,1,0,14,0,82,82,100,0
9,0,1,0,15,0,46,46,100,0
9,0,1,0,16,0,37,37,100,0
9,0,1,0,17,0,22,22,100,0
9,0,1,0,18,0,14,14,100,0
9,0,1,0,19,0,9,9,100,0
9,0,1,0,21,0,1,1,100,0
9,0,1,0,22,0,1,1,100,0
9,0,1,1,-25,1,1,0,0,100
9,0,1,1,-22,1,1,0,0,100
9,0,1,1,-21,1,1,0,0,100
9,0,1,1,-20,1,1,0,0,100
9,0,1,1,-19,4,4,0,0,100
9,0,1,1,-18,3,3,0,0,100
9,0,1,1,-17,2,2,0,0,100
9,0,1,1,-16,11,11,0,0,100
9,0,1,1,-15,15,15,0,0,100
9,0,1,1,-14,24,24,0,0,100
9,0,1,1,-13,60,60,0,0,100
9,0,1,1,-12,101,101,0,0,100
9,0,1,1,-11,145,145,0,0,100
9,0,1,1,-10,243,243,0,0,100
9,0,1,1,-9,341,341,0,0,100
9,0,1,1,-8,546,546,0,0,100
9,0,1,1,-7,809,810,1,0.1,99.9
9,0,1,1,-6,1140,1141,1,0.1,99.9
9,0,1,1,-5,1602,1614,12,0.7,99.3
9,0,1,1,-4,2066,2086,20,1,99
9,0,1,1,-3,2722,2813,91,3.2,96.8
9,0,1,1,-2,3023,3209,186,5.8,94.2
9,0,1,1,-1,3120,3660,540,14.8,85.2
9,0,1,1,0,2064,3928,1864,47.5,52.5
9,0,1,1,1,617,3996,3379,84.6,15.4
9,0,1,1,2,264,3717,3453,92.9,7.09999999999999
9,0,1,1,3,79,3014,2935,97.4,2.60000000000001
9,0,1,1,4,26,2457,2431,98.9,1.09999999999999
9,0,1,1,5,5,1844,1839,99.7,0.299999999999997
9,0,1,1,6,1,1315,1314,99.9,0.0999999999999943
9,0,1,1,7,0,839,839,100,0
9,0,1,1,8,0,628,628,100,0
9,0,1,1,9,0,426,426,100,0
9,0,1,1,10,0,290,290,100,0
9,0,1,1,11,0,167,167,100,0
9,0,1,1,12,0,134,134,100,0
9,0,1,1,13,0,53,53,100,0
9,0,1,1,14,0,26,26,100,0
9,0,1,1,15,0,20,20,100,0
9,0,1,1,16,0,20,20,100,0
9,0,1,1,17,0,5,5,100,0
9,0,1,1,18,0,4,4,100,0
9,0,1,1,19,0,3,3,100,0
9,0,1,1,20,0,3,3,100,0
9,0,1,2,-19,1,1,0,0,100
9,0,1,2,-18,5,5,0,0,100
9,0,1,2,-17,3,3,0,0,100
9,0,1,2,-16,5,5,0,0,100
9,0,1,2,-15,8,8,0,0,100
9,0,1,2,-14,12,12,0,0,100
9,0,1,2,-13,32,32,0,0,100
9,0,1,2,-12,36,36,0,0,100
9,0,1,2,-11,57,57,0,0,100
9,0,1,2,-10,92,92,0,0,100
9,0,1,2,-9,161,161,0,0,100
9,0,1,2,-8,207,207,0,0,100
9,0,1,2,-7,338,338,0,0,100
9,0,1,2,-6,485,487,2,0.4,99.6
9,0,1,2,-5,679,687,8,1.2,98.8
9,0,1,2,-4,1124,1138,14,1.2,98.8
9,0,1,2,-3,1542,1575,33,2.1,97.9
9,0,1,2,-2,1815,1928,113,5.9,94.1
9,0,1,2,-1,1948,2248,300,13.3,86.7
9,0,1,2,0,1501,2549,1048,41.1,58.9
9,0,1,2,1,300,1482,1182,79.8,20.2
9,0,1,2,2,88,1109,1021,92.1,7.89999999999999
9,0,1,2,3,24,989,965,97.6,2.40000000000001
9,0,1,2,4,5,798,793,99.4,0.599999999999994
9,0,1,2,5,0,584,584,100,0
9,0,1,2,6,0,379,379,100,0
9,0,1,2,7,0,279,279,100,0
9,0,1,2,8,0,211,211,100,0
9,0,1,2,9,0,137,137,100,0
9,0,1,2,10,0,86,86,100,0
9,0,1,2,11,0,59,59,100,0
9,0,1,2,12,0,23,23,100,0
9,0,1,2,13,0,16,16,100,0
9,0,1,2,14,0,8,8,100,0
9,0,1,2,15,0,7,7,100,0
9,0,1,2,16,0,5,5,100,0
9,0,1,2,17,0,3,3,100,0
9,0,1,2,18,0,2,2,100,0
9,0,1,2,19,0,1,1,100,0
9,0,1,2,21,0,1,1,100,0
9,0,1,12,-22,1,1,0,0,100
9,0,1,12,-21,1,1,0,0,100
9,0,1,12,-19,2,2,0,0,100
9,0,1,12,-18,4,4,0,0,100
9,0,1,12,-16,10,10,0,0,100
9,0,1,12,-15,10,10,0,0,100
9,0,1,12,-14,18,18,0,0,100
9,0,1,12,-13,27,27,0,0,100
9,0,1,12,-12,33,33,0,0,100
9,0,1,12,-11,65,65,0,0,100
9,0,1,12,-10,117,117,0,0,100
9,0,1,12,-9,157,157,0,0,100
9,0,1,12,-8,240,240,0,0,100
9,0,1,12,-7,339,339,0,0,100
9,0,1,12,-6,473,474,1,0.2,99.8
9,0,1,12,-5,680,686,6,0.9,99.1
9,0,1,12,-4,805,812,7,0.9,99.1
9,0,1,12,-3,1076,1104,28,2.5,97.5
9,0,1,12,-2,1209,1276,67,5.3,94.7
9,0,1,12,-1,1363,1534,171,11.1,88.9
9,0,1,12,0,1074,1728,654,37.8,62.2
9,0,1,12,1,357,1239,882,71.2,28.8
9,0,1,12,2,200,1312,1112,84.8,15.2
9,0,1,12,3,70,1047,977,93.3,6.69999999999999
9,0,1,12,4,26,797,771,96.7,3.3
9,0,1,12,5,7,631,624,98.9,1.09999999999999
9,0,1,12,6,1,471,470,99.8,0.200000000000003
9,0,1,12,7,0,312,312,100,0
9,0,1,12,8,0,248,248,100,0
9,0,1,12,9,0,140,140,100,0
9,0,1,12,10,0,114,114,100,0
9,0,1,12,11,0,77,77,100,0
9,0,1,12,12,0,41,41,100,0
9,0,1,12,13,0,19,19,100,0
9,0,1,12,14,0,6,6,100,0
9,0,1,12,15,0,11,11,100,0
9,0,1,12,16,0,5,5,100,0
9,0,1,12,17,0,5,5,100,0
9,0,1,12,18,0,1,1,100,0
9,0,1,12,19,0,1,1,100,0
9,0,1,12,20,0,2,2,100,0
9,0,1,3,-17,1,1,0,0,100
9,0,1,3,-15,2,2,0,0,100
9,0,1,3,-14,3,3,0,0,100
9,0,1,3,-13,5,5,0,0,100
9,0,1,3,-12,21,21,0,0,100
9,0,1,3,-11,18,18,0,0,100
9,0,1,3,-10,24,24,0,0,100
9,0,1,3,-9,57,57,0,0,100
9,0,1,3,-8,69,69,0,0,100
9,0,1,3,-7,94,94,0,0,100
9,0,1,3,-6,168,170,2,1.2,98.8
9,0,1,3,-5,237,237,0,0,100
9,0,1,3,-4,388,389,1,0.3,99.7
9,0,1,3,-3,436,443,7,1.6,98.4
9,0,1,3,-2,583,608,25,4.1,95.9
9,0,1,3,-1,569,628,59,9.4,90.6
9,0,1,3,0,400,605,205,33.9,66.1
9,0,1,3,1,126,409,283,69.2,30.8
9,0,1,3,2,22,274,252,92,8
9,0,1,3,3,9,221,212,95.9,4.10000000000001
9,0,1,3,4,0,215,215,100,0
9,0,1,3,5,0,140,140,100,0
9,0,1,3,6,0,100,100,100,0
9,0,1,3,7,0,79,79,100,0
9,0,1,3,8,0,50,50,100,0
9,0,1,3,9,0,30,30,100,0
9,0,1,3,10,0,21,21,100,0
9,0,1,3,11,0,16,16,100,0
9,0,1,3,12,0,8,8,100,0
9,0,1,3,13,0,10,10,100,0
9,0,1,3,14,0,4,4,100,0
9,0,1,3,15,0,2,2,100,0
9,0,1,3,16,0,1,1,100,0
9,0,1,13,-24,1,1,0,0,100
9,0,1,13,-18,1,1,0,0,100
9,0,1,13,-17,1,1,0,0,100
9,0,1,13,-16,1,1,0,0,100
9,0,1,13,-15,3,3,0,0,100
9,0,1,13,-14,7,7,0,0,100
9,0,1,13,-13,12,12,0,0,100
9,0,1,13,-12,19,19,0,0,100
9,0,1,13,-11,20,20,0,0,100
9,0,1,13,-10,60,60,0,0,100
9,0,1,13,-9,67,67,0,0,100
9,0,1,13,-8,91,91,0,0,100
9,0,1,13,-7,140,140,0,0,100
9,0,1,13,-6,243,243,0,0,100
9,0,1,13,-5,283,284,1,0.4,99.6
9,0,1,13,-4,424,426,2,0.5,99.5
9,0,1,13,-3,561,568,7,1.2,98.8
9,0,1,13,-2,609,631,22,3.5,96.5
9,0,1,13,-1,618,678,60,8.8,91.2
9,0,1,13,0,498,713,215,30.2,69.8
9,0,1,13,1,211,590,379,64.2,35.8
9,0,1,13,2,75,469,394,84,16
9,0,1,13,3,19,353,334,94.6,5.40000000000001
9,0,1,13,4,6,284,278,97.9,2.10000000000001
9,0,1,13,5,1,194,193,99.5,0.5
9,0,1,13,6,0,139,139,100,0
9,0,1,13,7,0,89,89,100,0
9,0,1,13,8,0,59,59,100,0
9,0,1,13,9,0,51,51,100,0
9,0,1,13,10,0,29,29,100,0
9,0,1,13,11,0,18,18,100,0
9,0,1,13,12,0,11,11,100,0
9,0,1,13,13,0,3,3,100,0
9,0,1,13,14,0,5,5,100,0
9,0,1,13,15,0,1,1,100,0
9,0,1,13,16,0,1,1,100,0
9,0,1,13,21,0,1,1,100,0
9,0,1,23,-23,1,1,0,0,100
9,0,1,23,-21,1,1,0,0,100
9,0,1,23,-15,2,2,0,0,100
9,0,1,23,-14,3,3,0,0,100
9,0,1,23,-13,8,8,0,0,100
9,0,1,23,-12,19,19,0,0,100
9,0,1,23,-11,25,25,0,0,100
9,0,1,23,-10,29,29,0,0,100
9,0,1,23,-9,47,47,0,0,100
9,0,1,23,-8,65,65,0,0,100
9,0,1,23,-7,111,111,0,0,100
9,0,1,23,-6,158,158,0,0,100
9,0,1,23,-5,233,234,1,0.4,99.6
9,0,1,23,-4,325,327,2,0.6,99.4
9,0,1,23,-3,389,394,5,1.3,98.7
9,0,1,23,-2,444,465,21,4.5,95.5
9,0,1,23,-1,461,514,53,10.3,89.7
9,0,1,23,0,345,470,125,26.6,73.4
9,0,1,23,1,209,444,235,52.9,47.1
9,0,1,23,2,65,378,313,82.8,17.2
9,0,1,23,3,17,244,227,93,7
9,0,1,23,4,3,194,191,98.5,1.5
9,0,1,23,5,1,157,156,99.4,0.599999999999994
9,0,1,23,6,0,125,125,100,0
9,0,1,23,7,0,74,74,100,0
9,0,1,23,8,0,43,43,100,0
9,0,1,23,9,0,33,33,100,0
9,0,1,23,10,0,25,25,100,0
9,0,1,23,11,0,12,12,100,0
9,0,1,23,12,0,7,7,100,0
9,0,1,23,13,0,1,1,100,0
9,0,1,23,14,0,1,1,100,0
9,0,1,23,17,0,1,1,100,0
9,0,1,23,21,0,1,1,100,0
9,0,1,23,22,0,1,1,100,0
9,0,1,23,26,0,1,1,100,0
9,0,1,123,-19,1,1,0,0,100
9,0,1,123,-18,1,1,0,0,100
9,0,1,123,-16,4,4,0,0,100
9,0,1,123,-15,2,2,0,0,100
9,0,1,123,-14,5,5,0,0,100
9,0,1,123,-13,7,7,0,0,100
9,0,1,123,-12,12,12,0,0,100
9,0,1,123,-11,22,22,0,0,100
9,0,1,123,-10,40,40,0,0,100
9,0,1,123,-9,38,38,0,0,100
9,0,1,123,-8,63,63,0,0,100
9,0,1,123,-7,105,105,0,0,100
9,0,1,123,-6,181,181,0,0,100
9,0,1,123,-5,261,262,1,0.4,99.6
9,0,1,123,-4,353,356,3,0.8,99.2
9,0,1,123,-3,481,489,8,1.6,98.4
9,0,1,123,-2,534,562,28,5,95
9,0,1,123,-1,608,679,71,10.5,89.5
9,0,1,123,0,511,691,180,26,74
9,0,1,123,1,240,510,270,52.9,47.1
9,0,1,123,2,108,354,246,69.5,30.5
9,0,1,123,3,40,274,234,85.4,14.6
9,0,1,123,4,22,225,203,90.2,9.8
9,0,1,123,5,5,163,158,96.9,3.10000000000001
9,0,1,123,6,2,131,129,98.5,1.5
9,0,1,123,7,0,87,87,100,0
9,0,1,123,8,0,52,52,100,0
9,0,1,123,9,0,42,42,100,0
9,0,1,123,10,0,30,30,100,0
9,0,1,123,11,0,18,18,100,0
9,0,1,123,12,0,11,11,100,0
9,0,1,123,13,0,9,9,100,0
9,0,1,123,14,0,4,4,100,0
9,0,1,123,15,0,3,3,100,0
9,0,1,123,17,0,1,1,100,0
9,0,1,123,19,0,1,1,100,0
9,0,2,0,-27,1,1,0,0,100
9,0,2,0,-23,1,1,0,0,100
9,0,2,0,-22,3,3,0,0,100
9,0,2,0,-21,3,3,0,0,100
9,0,2,0,-19,5,5,0,0,100
9,0,2,0,-18,8,8,0,0,100
9,0,2,0,-17,12,12,0,0,100
9,0,2,0,-16,26,26,0,0,100
9,0,2,0,-15,26,26,0,0,100
9,0,2,0,-14,84,84,0,0,100
9,0,2,0,-13,111,111,0,0,100
9,0,2,0,-12,163,163,0,0,100
9,0,2,0,-11,272,272,0,0,100
9,0,2,0,-10,403,403,0,0,100
9,0,2,0,-9,667,667,0,0,100
9,0,2,0,-8,980,980,0,0,100
9,0,2,0,-7,1500,1503,3,0.2,99.8
9,0,2,0,-6,2066,2070,4,0.2,99.8
9,0,2,0,-5,2876,2892,16,0.6,99.4
9,0,2,0,-4,4016,4068,52,1.3,98.7
9,0,2,0,-3,5014,5141,127,2.5,97.5
9,0,2,0,-2,6027,6523,496,7.6,92.4
9,0,2,0,-1,6378,7599,1221,16.1,83.9
9,0,2,0,0,3149,7545,4396,58.3,41.7
9,0,2,0,1,236,7737,7501,96.9,3.10000000000001
9,0,2,0,2,48,6789,6741,99.3,0.700000000000003
9,0,2,0,3,11,5586,5575,99.8,0.200000000000003
9,0,2,0,4,0,4389,4389,100,0
9,0,2,0,5,0,3294,3294,100,0
9,0,2,0,6,0,2326,2326,100,0
9,0,2,0,7,0,1612,1612,100,0
9,0,2,0,8,0,1152,1152,100,0
9,0,2,0,9,0,773,773,100,0
9,0,2,0,10,0,507,507,100,0
9,0,2,0,11,0,303,303,100,0
9,0,2,0,12,0,190,190,100,0
9,0,2,0,13,0,121,121,100,0
9,0,2,0,14,0,63,63,100,0
9,0,2,0,15,0,36,36,100,0
9,0,2,0,16,0,25,25,100,0
9,0,2,0,17,0,16,16,100,0
9,0,2,0,18,0,10,10,100,0
9,0,2,0,19,0,8,8,100,0
9,0,2,0,21,0,1,1,100,0
9,0,2,0,22,0,1,1,100,0
9,0,2,1,-27,1,1,0,0,100
9,0,2,1,-22,1,1,0,0,100
9,0,2,1,-21,1,1,0,0,100
9,0,2,1,-20,1,1,0,0,100
9,0,2,1,-19,6,6,0,0,100
9,0,2,1,-18,2,2,0,0,100
9,0,2,1,-17,6,6,0,0,100
9,0,2,1,-16,15,15,0,0,100
9,0,2,1,-15,18,18,0,0,100
9,0,2,1,-14,44,44,0,0,100
9,0,2,1,-13,82,82,0,0,100
9,0,2,1,-12,104,104,0,0,100
9,0,2,1,-11,190,190,0,0,100
9,0,2,1,-10,279,279,0,0,100
9,0,2,1,-9,406,406,0,0,100
9,0,2,1,-8,598,598,0,0,100
9,0,2,1,-7,938,939,1,0.1,99.9
9,0,2,1,-6,1258,1259,1,0.1,99.9
9,0,2,1,-5,1687,1699,12,0.7,99.3
9,0,2,1,-4,2244,2268,24,1.1,98.9
9,0,2,1,-3,2632,2707,75,2.8,97.2
9,0,2,1,-2,2978,3190,212,6.6,93.4
9,0,2,1,-1,3076,3646,570,15.6,84.4
9,0,2,1,0,1680,3823,2143,56.1,43.9
9,0,2,1,1,278,4260,3982,93.5,6.5
9,0,2,1,2,104,3731,3627,97.2,2.8
9,0,2,1,3,24,3053,3029,99.2,0.799999999999997
9,0,2,1,4,3,2464,2461,99.9,0.0999999999999943
9,0,2,1,5,2,1768,1766,99.9,0.0999999999999943
9,0,2,1,6,0,1248,1248,100,0
9,0,2,1,7,0,878,878,100,0
9,0,2,1,8,0,630,630,100,0
9,0,2,1,9,0,439,439,100,0
9,0,2,1,10,0,293,293,100,0
9,0,2,1,11,0,139,139,100,0
9,0,2,1,12,0,121,121,100,0
9,0,2,1,13,0,52,52,100,0
9,0,2,1,14,0,32,32,100,0
9,0,2,1,15,0,16,16,100,0
9,0,2,1,16,0,19,19,100,0
9,0,2,1,17,0,6,6,100,0
9,0,2,1,18,0,6,6,100,0
9,0,2,1,19,0,3,3,100,0
9,0,2,1,20,0,2,2,100,0
9,0,2,2,-19,2,2,0,0,100
9,0,2,2,-18,3,3,0,0,100
9,0,2,2,-17,3,3,0,0,100
9,0,2,2,-16,9,9,0,0,100
9,0,2,2,-15,18,18,0,0,100
9,0,2,2,-14,26,26,0,0,100
9,0,2,2,-13,35,35,0,0,100
9,0,2,2,-12,58,58,0,0,100
9,0,2,2,-11,76,76,0,0,100
9,0,2,2,-10,137,137,0,0,100
9,0,2,2,-9,225,225,0,0,100
9,0,2,2,-8,309,309,0,0,100
9,0,2,2,-7,459,460,1,0.2,99.8
9,0,2,2,-6,624,626,2,0.3,99.7
9,0,2,2,-5,888,895,7,0.8,99.2
9,0,2,2,-4,1407,1425,18,1.3,98.7
9,0,2,2,-3,1790,1853,63,3.4,96.6
9,0,2,2,-2,1976,2100,124,5.9,94.1
9,0,2,2,-1,1937,2327,390,16.8,83.2
9,0,2,2,0,1113,2295,1182,51.5,48.5
9,0,2,2,1,167,1730,1563,90.3,9.7
9,0,2,2,2,42,1752,1710,97.6,2.40000000000001
9,0,2,2,3,14,1556,1542,99.1,0.900000000000006
9,0,2,2,4,1,1155,1154,99.9,0.0999999999999943
9,0,2,2,5,1,820,819,99.9,0.0999999999999943
9,0,2,2,6,0,547,547,100,0
9,0,2,2,7,0,337,337,100,0
9,0,2,2,8,0,261,261,100,0
9,0,2,2,9,0,153,153,100,0
9,0,2,2,10,0,108,108,100,0
9,0,2,2,11,0,61,61,100,0
9,0,2,2,12,0,25,25,100,0
9,0,2,2,13,0,22,22,100,0
9,0,2,2,14,0,6,6,100,0
9,0,2,2,15,0,7,7,100,0
9,0,2,2,16,0,7,7,100,0
9,0,2,2,17,0,2,2,100,0
9,0,2,2,18,0,3,3,100,0
9,0,2,2,19,0,1,1,100,0
9,0,2,2,21,0,1,1,100,0
9,0,2,2,25,0,1,1,100,0
9,0,2,12,-22,1,1,0,0,100
9,0,2,12,-21,1,1,0,0,100
9,0,2,12,-20,1,1,0,0,100
9,0,2,12,-19,1,1,0,0,100
9,0,2,12,-18,5,5,0,0,100
9,0,2,12,-17,6,6,0,0,100
9,0,2,12,-16,9,9,0,0,100
9,0,2,12,-15,17,17,0,0,100
9,0,2,12,-14,24,24,0,0,100
9,0,2,12,-13,33,33,0,0,100
9,0,2,12,-12,54,54,0,0,100
9,0,2,12,-11,107,107,0,0,100
9,0,2,12,-10,155,155,0,0,100
9,0,2,12,-9,228,228,0,0,100
9,0,2,12,-8,350,350,0,0,100
9,0,2,12,-7,488,488,0,0,100
9,0,2,12,-6,636,637,1,0.2,99.8
9,0,2,12,-5,897,906,9,1,99
9,0,2,12,-4,1180,1187,7,0.6,99.4
9,0,2,12,-3,1324,1368,44,3.2,96.8
9,0,2,12,-2,1623,1707,84,4.9,95.1
9,0,2,12,-1,1711,2007,296,14.7,85.3
9,0,2,12,0,1107,2179,1072,49.2,50.8
9,0,2,12,1,211,1594,1383,86.8,13.2
9,0,2,12,2,92,1541,1449,94,6
9,0,2,12,3,34,1196,1162,97.2,2.8
9,0,2,12,4,8,942,934,99.2,0.799999999999997
9,0,2,12,5,2,656,654,99.7,0.299999999999997
9,0,2,12,6,0,544,544,100,0
9,0,2,12,7,0,337,337,100,0
9,0,2,12,8,0,268,268,100,0
9,0,2,12,9,0,197,197,100,0
9,0,2,12,10,0,136,136,100,0
9,0,2,12,11,0,78,78,100,0
9,0,2,12,12,0,37,37,100,0
9,0,2,12,13,0,16,16,100,0
9,0,2,12,14,0,13,13,100,0
9,0,2,12,15,0,8,8,100,0
9,0,2,12,16,0,7,7,100,0
9,0,2,12,17,0,4,4,100,0
9,0,2,12,18,0,2,2,100,0
9,0,2,12,20,0,1,1,100,0
9,0,2,3,-18,1,1,0,0,100
9,0,2,3,-17,2,2,0,0,100
9,0,2,3,-16,3,3,0,0,100
9,0,2,3,-15,3,3,0,0,100
9,0,2,3,-14,9,9,0,0,100
9,0,2,3,-13,18,18,0,0,100
9,0,2,3,-12,28,28,0,0,100
9,0,2,3,-11,33,33,0,0,100
9,0,2,3,-10,48,48,0,0,100
9,0,2,3,-9,79,79,0,0,100
9,0,2,3,-8,143,143,0,0,100
9,0,2,3,-7,177,177,0,0,100
9,0,2,3,-6,276,280,4,1.4,98.6
9,0,2,3,-5,378,378,0,0,100
9,0,2,3,-4,546,552,6,1.1,98.9
9,0,2,3,-3,678,697,19,2.7,97.3
9,0,2,3,-2,743,796,53,6.7,93.3
9,0,2,3,-1,717,834,117,14,86
9,0,2,3,0,388,809,421,52,48
9,0,2,3,1,72,684,612,89.5,10.5
9,0,2,3,2,9,507,498,98.2,1.8
9,0,2,3,3,4,439,435,99.1,0.900000000000006
9,0,2,3,4,0,377,377,100,0
9,0,2,3,5,0,234,234,100,0
9,0,2,3,6,0,181,181,100,0
9,0,2,3,7,0,115,115,100,0
9,0,2,3,8,0,90,90,100,0
9,0,2,3,9,0,61,61,100,0
9,0,2,3,10,0,39,39,100,0
9,0,2,3,11,0,18,18,100,0
9,0,2,3,12,0,18,18,100,0
9,0,2,3,13,0,11,11,100,0
9,0,2,3,14,0,6,6,100,0
9,0,2,3,15,0,3,3,100,0
9,0,2,3,16,0,1,1,100,0
9,0,2,3,19,0,1,1,100,0
9,0,2,3,20,0,1,1,100,0
9,0,2,13,-24,1,1,0,0,100
9,0,2,13,-22,1,1,0,0,100
9,0,2,13,-19,3,3,0,0,100
9,0,2,13,-18,2,2,0,0,100
9,0,2,13,-16,4,4,0,0,100
9,0,2,13,-15,5,5,0,0,100
9,0,2,13,-14,16,16,0,0,100
9,0,2,13,-13,18,18,0,0,100
9,0,2,13,-12,25,25,0,0,100
9,0,2,13,-11,42,42,0,0,100
9,0,2,13,-10,56,56,0,0,100
9,0,2,13,-9,90,90,0,0,100
9,0,2,13,-8,137,137,0,0,100
9,0,2,13,-7,232,232,0,0,100
9,0,2,13,-6,316,318,2,0.6,99.4
9,0,2,13,-5,430,432,2,0.5,99.5
9,0,2,13,-4,574,581,7,1.2,98.8
9,0,2,13,-3,697,717,20,2.8,97.2
9,0,2,13,-2,781,835,54,6.5,93.5
9,0,2,13,-1,796,939,143,15.2,84.8
9,0,2,13,0,509,957,448,46.8,53.2
9,0,2,13,1,134,867,733,84.5,15.5
9,0,2,13,2,39,640,601,93.9,6.10000000000001
9,0,2,13,3,11,522,511,97.9,2.10000000000001
9,0,2,13,4,0,377,377,100,0
9,0,2,13,5,1,274,273,99.6,0.400000000000006
9,0,2,13,6,0,201,201,100,0
9,0,2,13,7,0,128,128,100,0
9,0,2,13,8,0,98,98,100,0
9,0,2,13,9,0,53,53,100,0
9,0,2,13,10,0,41,41,100,0
9,0,2,13,11,0,26,26,100,0
9,0,2,13,12,0,18,18,100,0
9,0,2,13,13,0,5,5,100,0
9,0,2,13,14,0,4,4,100,0
9,0,2,13,15,0,3,3,100,0
9,0,2,13,16,0,4,4,100,0
9,0,2,13,17,0,2,2,100,0
9,0,2,13,18,0,1,1,100,0
9,0,2,13,21,0,1,1,100,0
9,0,2,23,-21,2,2,0,0,100
9,0,2,23,-19,1,1,0,0,100
9,0,2,23,-17,2,2,0,0,100
9,0,2,23,-16,1,1,0,0,100
9,0,2,23,-15,4,4,0,0,100
9,0,2,23,-14,8,8,0,0,100
9,0,2,23,-13,13,13,0,0,100
9,0,2,23,-12,24,24,0,0,100
9,0,2,23,-11,30,30,0,0,100
9,0,2,23,-10,29,29,0,0,100
9,0,2,23,-9,64,64,0,0,100
9,0,2,23,-8,94,94,0,0,100
9,0,2,23,-7,148,148,0,0,100
9,0,2,23,-6,199,199,0,0,100
9,0,2,23,-5,284,286,2,0.7,99.3
9,0,2,23,-4,354,359,5,1.4,98.6
9,0,2,23,-3,400,409,9,2.2,97.8
9,0,2,23,-2,521,553,32,5.8,94.2
9,0,2,23,-1,487,569,82,14.4,85.6
9,0,2,23,0,251,484,233,48.1,51.9
9,0,2,23,1,79,404,325,80.4,19.6
9,0,2,23,2,32,405,373,92.1,7.89999999999999
9,0,2,23,3,9,331,322,97.3,2.7
9,0,2,23,4,0,275,275,100,0
9,0,2,23,5,0,217,217,100,0
9,0,2,23,6,0,155,155,100,0
9,0,2,23,7,0,86,86,100,0
9,0,2,23,8,0,58,58,100,0
9,0,2,23,9,0,34,34,100,0
9,0,2,23,10,0,28,28,100,0
9,0,2,23,11,0,16,16,100,0
9,0,2,23,12,0,6,6,100,0
9,0,2,23,13,0,2,2,100,0
9,0,2,23,14,0,1,1,100,0
9,0,2,23,16,0,1,1,100,0
9,0,2,23,17,0,1,1,100,0
9,0,2,23,21,0,1,1,100,0
9,0,2,123,-20,2,2,0,0,100
9,0,2,123,-19,2,2,0,0,100
9,0,2,123,-18,3,3,0,0,100
9,0,2,123,-17,1,1,0,0,100
9,0,2,123,-16,4,4,0,0,100
9,0,2,123,-15,6,6,0,0,100
9,0,2,123,-14,13,13,0,0,100
9,0,2,123,-13,17,17,0,0,100
9,0,2,123,-12,20,20,0,0,100
9,0,2,123,-11,29,29,0,0,100
9,0,2,123,-10,48,48,0,0,100
9,0,2,123,-9,70,70,0,0,100
9,0,2,123,-8,108,108,0,0,100
9,0,2,123,-7,163,163,0,0,100
9,0,2,123,-6,238,239,1,0.4,99.6
9,0,2,123,-5,296,298,2,0.7,99.3
9,0,2,123,-4,403,409,6,1.5,98.5
9,0,2,123,-3,498,509,11,2.2,97.8
9,0,2,123,-2,622,663,41,6.2,93.8
9,0,2,123,-1,650,767,117,15.3,84.7
9,0,2,123,0,453,767,314,40.9,59.1
9,0,2,123,1,125,542,417,76.9,23.1
9,0,2,123,2,59,424,365,86.1,13.9
9,0,2,123,3,15,331,316,95.5,4.5
9,0,2,123,4,5,258,253,98.1,1.90000000000001
9,0,2,123,5,1,161,160,99.4,0.599999999999994
9,0,2,123,6,0,169,169,100,0
9,0,2,123,7,0,70,70,100,0
9,0,2,123,8,0,61,61,100,0
9,0,2,123,9,0,53,53,100,0
9,0,2,123,10,0,39,39,100,0
9,0,2,123,11,0,26,26,100,0
9,0,2,123,12,0,8,8,100,0
9,0,2,123,13,0,6,6,100,0
9,0,2,123,14,0,3,3,100,0
9,0,2,123,15,0,3,3,100,0
9,0,2,123,16,0,2,2,100,0
9,1,0,0,-27,1,1,0,0,100
9,1,0,0,-25,1,1,0,0,100
9,1,0,0,-23,1,1,0,0,100
9,1,0,0,-22,5,5,0,0,100
9,1,0,0,-21,4,4,0,0,100
9,1,0,0,-20,4,4,0,0,100
9,1,0,0,-19,9,9,0,0,100
9,1,0,0,-18,16,16,0,0,100
9,1,0,0,-17,21,21,0,0,100
9,1,0,0,-16,53,53,0,0,100
9,1,0,0,-15,64,64,0,0,100
9,1,0,0,-14,155,155,0,0,100
9,1,0,0,-13,215,215,0,0,100
9,1,0,0,-12,338,338,0,0,100
9,1,0,0,-11,564,564,0,0,100
9,1,0,0,-10,865,865,0,0,100
9,1,0,0,-9,1332,1332,0,0,100
9,1,0,0,-8,1973,1973,0,0,100
9,1,0,0,-7,2960,2965,5,0.2,99.8
9,1,0,0,-6,4073,4086,13,0.3,99.7
9,1,0,0,-5,5637,5679,42,0.7,99.3
9,1,0,0,-4,7554,7645,91,1.2,98.8
9,1,0,0,-3,9280,9578,298,3.1,96.9
9,1,0,0,-2,10756,11639,883,7.6,92.4
9,1,0,0,-1,10908,13199,2291,17.4,82.6
9,1,0,0,0,5166,13267,8101,61.1,38.9
9,1,0,1,-25,1,1,0,0,100
9,1,0,1,-22,2,2,0,0,100
9,1,0,1,-21,1,1,0,0,100
9,1,0,1,-20,1,1,0,0,100
9,1,0,1,-19,1,1,0,0,100
9,1,0,1,-18,6,6,0,0,100
9,1,0,1,-17,5,5,0,0,100
9,1,0,1,-16,16,16,0,0,100
9,1,0,1,-15,20,20,0,0,100
9,1,0,1,-14,37,37,0,0,100
9,1,0,1,-13,51,51,0,0,100
9,1,0,1,-12,90,90,0,0,100
9,1,0,1,-11,141,141,0,0,100
9,1,0,1,-10,215,215,0,0,100
9,1,0,1,-9,320,320,0,0,100
9,1,0,1,-8,537,537,0,0,100
9,1,0,1,-7,757,761,4,0.5,99.5
9,1,0,1,-6,1012,1019,7,0.7,99.3
9,1,0,1,-5,1406,1436,30,2.1,97.9
9,1,0,1,-4,1856,1907,51,2.7,97.3
9,1,0,1,-3,2254,2436,182,7.5,92.5
9,1,0,1,-2,2550,3017,467,15.5,84.5
9,1,0,1,-1,2471,3492,1021,29.2,70.8
9,1,0,1,0,1231,3686,2455,66.6,33.4
9,1,0,2,-20,1,1,0,0,100
9,1,0,2,-19,1,1,0,0,100
9,1,0,2,-18,1,1,0,0,100
9,1,0,2,-17,4,4,0,0,100
9,1,0,2,-16,3,3,0,0,100
9,1,0,2,-15,5,5,0,0,100
9,1,0,2,-14,9,9,0,0,100
9,1,0,2,-13,8,8,0,0,100
9,1,0,2,-12,19,19,0,0,100
9,1,0,2,-11,36,36,0,0,100
9,1,0,2,-10,48,48,0,0,100
9,1,0,2,-9,72,72,0,0,100
9,1,0,2,-8,121,121,0,0,100
9,1,0,2,-7,188,188,0,0,100
9,1,0,2,-6,250,251,1,0.4,99.6
9,1,0,2,-5,345,351,6,1.7,98.3
9,1,0,2,-4,469,487,18,3.7,96.3
9,1,0,2,-3,511,547,36,6.6,93.4
9,1,0,2,-2,542,654,112,17.1,82.9
9,1,0,2,-1,440,716,276,38.5,61.5
9,1,0,2,0,217,809,592,73.2,26.8
9,1,0,12,-25,1,1,0,0,100
9,1,0,12,-23,1,1,0,0,100
9,1,0,12,-22,1,1,0,0,100
9,1,0,12,-20,1,1,0,0,100
9,1,0,12,-18,2,2,0,0,100
9,1,0,12,-17,3,3,0,0,100
9,1,0,12,-16,3,3,0,0,100
9,1,0,12,-15,4,4,0,0,100
9,1,0,12,-14,10,10,0,0,100
9,1,0,12,-13,17,17,0,0,100
9,1,0,12,-12,21,21,0,0,100
9,1,0,12,-11,26,26,0,0,100
9,1,0,12,-10,59,59,0,0,100
9,1,0,12,-9,96,96,0,0,100
9,1,0,12,-8,128,128,0,0,100
9,1,0,12,-7,178,181,3,1.7,98.3
9,1,0,12,-6,255,257,2,0.8,99.2
9,1,0,12,-5,354,372,18,4.8,95.2
9,1,0,12,-4,472,501,29,5.8,94.2
9,1,0,12,-3,542,637,95,14.9,85.1
9,1,0,12,-2,570,795,225,28.3,71.7
9,1,0,12,-1,295,568,273,48.1,51.9
9,1,0,12,0,201,740,539,72.8,27.2
9,1,0,3,-16,2,2,0,0,100
9,1,0,3,-15,2,2,0,0,100
9,1,0,3,-14,3,3,0,0,100
9,1,0,3,-13,3,3,0,0,100
9,1,0,3,-12,2,2,0,0,100
9,1,0,3,-11,5,5,0,0,100
9,1,0,3,-10,10,10,0,0,100
9,1,0,3,-9,15,15,0,0,100
9,1,0,3,-8,18,18,0,0,100
9,1,0,3,-7,22,22,0,0,100
9,1,0,3,-6,40,41,1,2.4,97.6
9,1,0,3,-5,75,77,2,2.6,97.4
9,1,0,3,-4,86,93,7,7.5,92.5
9,1,0,3,-3,75,80,5,6.2,93.8
9,1,0,3,-2,96,113,17,15,85
9,1,0,3,-1,72,133,61,45.9,54.1
9,1,0,3,0,31,153,122,79.7,20.3
9,1,0,13,-17,1,1,0,0,100
9,1,0,13,-16,3,3,0,0,100
9,1,0,13,-14,1,1,0,0,100
9,1,0,13,-13,3,3,0,0,100
9,1,0,13,-12,6,6,0,0,100
9,1,0,13,-11,8,8,0,0,100
9,1,0,13,-10,11,11,0,0,100
9,1,0,13,-9,18,18,0,0,100
9,1,0,13,-8,28,28,0,0,100
9,1,0,13,-7,46,46,0,0,100
9,1,0,13,-6,47,47,0,0,100
9,1,0,13,-5,85,88,3,3.4,96.6
9,1,0,13,-4,114,122,8,6.6,93.4
9,1,0,13,-3,147,175,28,16,84
9,1,0,13,-2,169,232,63,27.2,72.8
9,1,0,13,-1,102,247,145,58.7,41.3
9,1,0,13,0,56,333,277,83.2,16.8
9,1,0,23,-22,1,1,0,0,100
9,1,0,23,-15,2,2,0,0,100
9,1,0,23,-14,2,2,0,0,100
9,1,0,23,-12,5,5,0,0,100
9,1,0,23,-11,12,12,0,0,100
9,1,0,23,-10,17,17,0,0,100
9,1,0,23,-9,14,14,0,0,100
9,1,0,23,-8,18,18,0,0,100
9,1,0,23,-7,40,40,0,0,100
9,1,0,23,-6,40,41,1,2.4,97.6
9,1,0,23,-5,83,84,1,1.2,98.8
9,1,0,23,-4,79,89,10,11.2,88.8
9,1,0,23,-3,99,116,17,14.7,85.3
9,1,0,23,-2,66,116,50,43.1,56.9
9,1,0,23,-1,41,125,84,67.2,32.8
9,1,0,23,0,18,137,119,86.9,13.1
9,1,0,123,-25,1,1,0,0,100
9,1,0,123,-16,1,1,0,0,100
9,1,0,123,-15,1,1,0,0,100
9,1,0,123,-14,2,2,0,0,100
9,1,0,123,-13,2,2,0,0,100
9,1,0,123,-12,2,2,0,0,100
9,1,0,123,-11,6,6,0,0,100
9,1,0,123,-10,22,22,0,0,100
9,1,0,123,-9,24,24,0,0,100
9,1,0,123,-8,36,36,0,0,100
9,1,0,123,-7,35,37,2,5.4,94.6
9,1,0,123,-6,55,58,3,5.2,94.8
9,1,0,123,-5,80,89,9,10.1,89.9
9,1,0,123,-4,93,113,20,17.7,82.3
9,1,0,123,-3,102,143,41,28.7,71.3
9,1,0,123,-2,84,151,67,44.4,55.6
9,1,0,123,-1,70,189,119,63,37
9,1,0,123,0,72,453,381,84.1,15.9
9,1,1,0,-27,1,1,0,0,100
9,1,1,0,-23,1,1,0,0,100
9,1,1,0,-22,3,3,0,0,100
9,1,1,0,-21,3,3,0,0,100
9,1,1,0,-20,2,2,0,0,100
9,1,1,0,-19,8,8,0,0,100
9,1,1,0,-18,9,9,0,0,100
9,1,1,0,-17,13,13,0,0,100
9,1,1,0,-16,32,32,0,0,100
9,1,1,0,-15,40,40,0,0,100
9,1,1,0,-14,111,111,0,0,100
9,1,1,0,-13,153,153,0,0,100
9,1,1,0,-12,241,241,0,0,100
9,1,1,0,-11,376,376,0,0,100
9,1,1,0,-10,603,603,0,0,100
9,1,1,0,-9,930,930,0,0,100
9,1,1,0,-8,1323,1323,0,0,100
9,1,1,0,-7,2045,2046,1,0,100
9,1,1,0,-6,2807,2810,3,0.1,99.9
9,1,1,0,-5,3923,3929,6,0.2,99.8
9,1,1,0,-4,5332,5358,26,0.5,99.5
9,1,1,0,-3,6699,6782,83,1.2,98.8
9,1,1,0,-2,7797,8099,302,3.7,96.3
9,1,1,0,-1,8371,9281,910,9.8,90.2
9,1,1,0,0,3991,9146,5155,56.4,43.6
9,1,1,1,-22,1,1,0,0,100
9,1,1,1,-21,2,2,0,0,100
9,1,1,1,-20,2,2,0,0,100
9,1,1,1,-19,3,3,0,0,100
9,1,1,1,-18,3,3,0,0,100
9,1,1,1,-17,3,3,0,0,100
9,1,1,1,-16,17,17,0,0,100
9,1,1,1,-15,22,22,0,0,100
9,1,1,1,-14,38,38,0,0,100
9,1,1,1,-13,59,59,0,0,100
9,1,1,1,-12,93,93,0,0,100
9,1,1,1,-11,154,154,0,0,100
9,1,1,1,-10,263,263,0,0,100
9,1,1,1,-9,375,375,0,0,100
9,1,1,1,-8,622,622,0,0,100
9,1,1,1,-7,922,924,2,0.2,99.8
9,1,1,1,-6,1196,1202,6,0.5,99.5
9,1,1,1,-5,1693,1701,8,0.5,99.5
9,1,1,1,-4,2233,2259,26,1.2,98.8
9,1,1,1,-3,2889,2980,91,3.1,96.9
9,1,1,1,-2,3263,3574,311,8.7,91.3
9,1,1,1,-1,2971,3668,697,19,81
9,1,1,1,0,1446,3806,2360,62,38
9,1,1,2,-18,1,1,0,0,100
9,1,1,2,-17,5,5,0,0,100
9,1,1,2,-16,3,3,0,0,100
9,1,1,2,-15,7,7,0,0,100
9,1,1,2,-14,14,14,0,0,100
9,1,1,2,-13,16,16,0,0,100
9,1,1,2,-12,29,29,0,0,100
9,1,1,2,-11,58,58,0,0,100
9,1,1,2,-10,77,77,0,0,100
9,1,1,2,-9,135,135,0,0,100
9,1,1,2,-8,202,202,0,0,100
9,1,1,2,-7,303,303,0,0,100
9,1,1,2,-6,391,391,0,0,100
9,1,1,2,-5,561,564,3,0.5,99.5
9,1,1,2,-4,768,779,11,1.4,98.6
9,1,1,2,-3,895,926,31,3.3,96.7
9,1,1,2,-2,981,1078,97,9,91
9,1,1,2,-1,1521,2049,528,25.8,74.2
9,1,1,2,0,842,2561,1719,67.1,32.9
9,1,1,12,-23,1,1,0,0,100
9,1,1,12,-20,1,1,0,0,100
9,1,1,12,-19,3,3,0,0,100
9,1,1,12,-18,1,1,0,0,100
9,1,1,12,-17,2,2,0,0,100
9,1,1,12,-16,5,5,0,0,100
9,1,1,12,-15,9,9,0,0,100
9,1,1,12,-14,15,15,0,0,100
9,1,1,12,-13,21,21,0,0,100
9,1,1,12,-12,32,32,0,0,100
9,1,1,12,-11,63,63,0,0,100
9,1,1,12,-10,81,81,0,0,100
9,1,1,12,-9,147,147,0,0,100
9,1,1,12,-8,216,216,0,0,100
9,1,1,12,-7,347,348,1,0.3,99.7
9,1,1,12,-6,438,442,4,0.9,99.1
9,1,1,12,-5,614,620,6,1,99
9,1,1,12,-4,791,815,24,2.9,97.1
9,1,1,12,-3,949,1033,84,8.1,91.9
9,1,1,12,-2,1047,1265,218,17.2,82.8
9,1,1,12,-1,826,1237,411,33.2,66.8
9,1,1,12,0,692,2268,1576,69.5,30.5
9,1,1,3,-22,1,1,0,0,100
9,1,1,3,-19,1,1,0,0,100
9,1,1,3,-16,2,2,0,0,100
9,1,1,3,-15,2,2,0,0,100
9,1,1,3,-14,6,6,0,0,100
9,1,1,3,-13,5,5,0,0,100
9,1,1,3,-12,6,6,0,0,100
9,1,1,3,-11,8,8,0,0,100
9,1,1,3,-10,22,22,0,0,100
9,1,1,3,-9,25,25,0,0,100
9,1,1,3,-8,47,47,0,0,100
9,1,1,3,-7,62,62,0,0,100
9,1,1,3,-6,112,113,1,0.9,99.1
9,1,1,3,-5,146,146,0,0,100
9,1,1,3,-4,197,199,2,1,99
9,1,1,3,-3,227,233,6,2.6,97.4
9,1,1,3,-2,244,273,29,10.6,89.4
9,1,1,3,-1,290,461,171,37.1,62.9
9,1,1,3,0,112,492,380,77.2,22.8
9,1,1,13,-18,1,1,0,0,100
9,1,1,13,-17,2,2,0,0,100
9,1,1,13,-16,3,3,0,0,100
9,1,1,13,-15,3,3,0,0,100
9,1,1,13,-14,8,8,0,0,100
9,1,1,13,-13,10,10,0,0,100
9,1,1,13,-12,13,13,0,0,100
9,1,1,13,-11,15,15,0,0,100
9,1,1,13,-10,36,36,0,0,100
9,1,1,13,-9,58,58,0,0,100
9,1,1,13,-8,75,75,0,0,100
9,1,1,13,-7,127,127,0,0,100
9,1,1,13,-6,160,161,1,0.6,99.4
9,1,1,13,-5,216,218,2,0.9,99.1
9,1,1,13,-4,274,281,7,2.5,97.5
9,1,1,13,-3,344,378,34,9,91
9,1,1,13,-2,377,453,76,16.8,83.2
9,1,1,13,-1,370,623,253,40.6,59.4
9,1,1,13,0,176,822,646,78.6,21.4
9,1,1,23,-22,1,1,0,0,100
9,1,1,23,-17,2,2,0,0,100
9,1,1,23,-16,2,2,0,0,100
9,1,1,23,-15,2,2,0,0,100
9,1,1,23,-14,1,1,0,0,100
9,1,1,23,-13,2,2,0,0,100
9,1,1,23,-12,10,10,0,0,100
9,1,1,23,-11,13,13,0,0,100
9,1,1,23,-10,15,15,0,0,100
9,1,1,23,-9,36,36,0,0,100
9,1,1,23,-8,47,47,0,0,100
9,1,1,23,-7,77,77,0,0,100
9,1,1,23,-6,96,96,0,0,100
9,1,1,23,-5,131,135,4,3,97
9,1,1,23,-4,218,229,11,4.8,95.2
9,1,1,23,-3,209,227,18,7.9,92.1
9,1,1,23,-2,326,439,113,25.7,74.3
9,1,1,23,-1,191,411,220,53.5,46.5
9,1,1,23,0,128,474,346,73,27
9,1,1,123,-19,2,2,0,0,100
9,1,1,123,-17,1,1,0,0,100
9,1,1,123,-16,1,1,0,0,100
9,1,1,123,-15,1,1,0,0,100
9,1,1,123,-14,1,1,0,0,100
9,1,1,123,-13,7,7,0,0,100
9,1,1,123,-12,5,5,0,0,100
9,1,1,123,-11,18,18,0,0,100
9,1,1,123,-10,26,26,0,0,100
9,1,1,123,-9,39,39,0,0,100
9,1,1,123,-8,48,48,0,0,100
9,1,1,123,-7,79,81,2,2.5,97.5
9,1,1,123,-6,105,106,1,0.9,99.1
9,1,1,123,-5,157,161,4,2.5,97.5
9,1,1,123,-4,216,236,20,8.5,91.5
9,1,1,123,-3,249,296,47,15.9,84.1
9,1,1,123,-2,258,366,108,29.5,70.5
9,1,1,123,-1,290,585,295,50.4,49.6
9,1,1,123,0,280,1277,997,78.1,21.9
9,1,2,0,-27,1,1,0,0,100
9,1,2,0,-23,1,1,0,0,100
9,1,2,0,-22,2,2,0,0,100
9,1,2,0,-21,3,3,0,0,100
9,1,2,0,-20,1,1,0,0,100
9,1,2,0,-19,6,6,0,0,100
9,1,2,0,-18,11,11,0,0,100
9,1,2,0,-17,8,8,0,0,100
9,1,2,0,-16,25,25,0,0,100
9,1,2,0,-15,28,28,0,0,100
9,1,2,0,-14,84,84,0,0,100
9,1,2,0,-13,114,114,0,0,100
9,1,2,0,-12,193,193,0,0,100
9,1,2,0,-11,291,291,0,0,100
9,1,2,0,-10,447,447,0,0,100
9,1,2,0,-9,696,696,0,0,100
9,1,2,0,-8,984,984,0,0,100
9,1,2,0,-7,1510,1510,0,0,100
9,1,2,0,-6,2164,2165,1,0,100
9,1,2,0,-5,2930,2931,1,0,100
9,1,2,0,-4,4039,4046,7,0.2,99.8
9,1,2,0,-3,5135,5160,25,0.5,99.5
9,1,2,0,-2,6122,6199,77,1.2,98.8
9,1,2,0,-1,6814,7078,264,3.7,96.3
9,1,2,0,0,3320,6844,3524,51.5,48.5
9,1,2,1,-21,3,3,0,0,100
9,1,2,1,-20,2,2,0,0,100
9,1,2,1,-19,4,4,0,0,100
9,1,2,1,-18,5,5,0,0,100
9,1,2,1,-17,4,4,0,0,100
9,1,2,1,-16,12,12,0,0,100
9,1,2,1,-15,23,23,0,0,100
9,1,2,1,-14,38,38,0,0,100
9,1,2,1,-13,63,63,0,0,100
9,1,2,1,-12,96,96,0,0,100
9,1,2,1,-11,165,165,0,0,100
9,1,2,1,-10,252,252,0,0,100
9,1,2,1,-9,364,364,0,0,100
9,1,2,1,-8,596,596,0,0,100
9,1,2,1,-7,844,845,1,0.1,99.9
9,1,2,1,-6,1144,1145,1,0.1,99.9
9,1,2,1,-5,1618,1621,3,0.2,99.8
9,1,2,1,-4,2267,2276,9,0.4,99.6
9,1,2,1,-3,2975,3009,34,1.1,98.9
9,1,2,1,-2,3491,3622,131,3.6,96.4
9,1,2,1,-1,3583,3918,335,8.6,91.4
9,1,2,1,0,1759,3744,1985,53,47
9,1,2,2,-22,1,1,0,0,100
9,1,2,2,-18,2,2,0,0,100
9,1,2,2,-17,4,4,0,0,100
9,1,2,2,-16,3,3,0,0,100
9,1,2,2,-15,9,9,0,0,100
9,1,2,2,-14,18,18,0,0,100
9,1,2,2,-13,18,18,0,0,100
9,1,2,2,-12,37,37,0,0,100
9,1,2,2,-11,63,63,0,0,100
9,1,2,2,-10,99,99,0,0,100
9,1,2,2,-9,166,166,0,0,100
9,1,2,2,-8,236,236,0,0,100
9,1,2,2,-7,384,384,0,0,100
9,1,2,2,-6,548,549,1,0.2,99.8
9,1,2,2,-5,770,771,1,0.1,99.9
9,1,2,2,-4,1111,1114,3,0.3,99.7
9,1,2,2,-3,1350,1365,15,1.1,98.9
9,1,2,2,-2,1569,1628,59,3.6,96.4
9,1,2,2,-1,1751,1998,247,12.4,87.6
9,1,2,2,0,892,2055,1163,56.6,43.4
9,1,2,12,-23,1,1,0,0,100
9,1,2,12,-21,1,1,0,0,100
9,1,2,12,-20,1,1,0,0,100
9,1,2,12,-19,3,3,0,0,100
9,1,2,12,-18,3,3,0,0,100
9,1,2,12,-17,1,1,0,0,100
9,1,2,12,-16,5,5,0,0,100
9,1,2,12,-15,10,10,0,0,100
9,1,2,12,-14,18,18,0,0,100
9,1,2,12,-13,23,23,0,0,100
9,1,2,12,-12,42,42,0,0,100
9,1,2,12,-11,68,68,0,0,100
9,1,2,12,-10,91,91,0,0,100
9,1,2,12,-9,144,144,0,0,100
9,1,2,12,-8,265,265,0,0,100
9,1,2,12,-7,428,429,1,0.2,99.8
9,1,2,12,-6,483,484,1,0.2,99.8
9,1,2,12,-5,693,695,2,0.3,99.7
9,1,2,12,-4,1004,1015,11,1.1,98.9
9,1,2,12,-3,1204,1252,48,3.8,96.2
9,1,2,12,-2,1395,1513,118,7.8,92.2
9,1,2,12,-1,1386,1639,253,15.4,84.6
9,1,2,12,0,1059,2572,1513,58.8,41.2
9,1,2,3,-18,2,2,0,0,100
9,1,2,3,-17,1,1,0,0,100
9,1,2,3,-16,2,2,0,0,100
9,1,2,3,-15,2,2,0,0,100
9,1,2,3,-14,5,5,0,0,100
9,1,2,3,-13,7,7,0,0,100
9,1,2,3,-12,9,9,0,0,100
9,1,2,3,-11,18,18,0,0,100
9,1,2,3,-10,37,37,0,0,100
9,1,2,3,-9,48,48,0,0,100
9,1,2,3,-8,83,83,0,0,100
9,1,2,3,-7,121,121,0,0,100
9,1,2,3,-6,162,162,0,0,100
9,1,2,3,-5,262,263,1,0.4,99.6
9,1,2,3,-4,339,341,2,0.6,99.4
9,1,2,3,-3,434,443,9,2,98
9,1,2,3,-2,450,472,22,4.7,95.3
9,1,2,3,-1,658,760,102,13.4,86.6
9,1,2,3,0,234,611,377,61.7,38.3
9,1,2,13,-22,1,1,0,0,100
9,1,2,13,-18,4,4,0,0,100
9,1,2,13,-16,1,1,0,0,100
9,1,2,13,-15,2,2,0,0,100
9,1,2,13,-14,5,5,0,0,100
9,1,2,13,-13,8,8,0,0,100
9,1,2,13,-12,16,16,0,0,100
9,1,2,13,-11,28,28,0,0,100
9,1,2,13,-10,31,31,0,0,100
9,1,2,13,-9,58,58,0,0,100
9,1,2,13,-8,83,83,0,0,100
9,1,2,13,-7,139,139,0,0,100
9,1,2,13,-6,213,215,2,0.9,99.1
9,1,2,13,-5,306,307,1,0.3,99.7
9,1,2,13,-4,392,395,3,0.8,99.2
9,1,2,13,-3,491,514,23,4.5,95.5
9,1,2,13,-2,590,641,51,8,92
9,1,2,13,-1,685,828,143,17.3,82.7
9,1,2,13,0,371,1029,658,63.9,36.1
9,1,2,23,-18,1,1,0,0,100
9,1,2,23,-17,1,1,0,0,100
9,1,2,23,-16,2,2,0,0,100
9,1,2,23,-15,4,4,0,0,100
9,1,2,23,-14,1,1,0,0,100
9,1,2,23,-13,9,9,0,0,100
9,1,2,23,-12,13,13,0,0,100
9,1,2,23,-11,12,12,0,0,100
9,1,2,23,-10,22,22,0,0,100
9,1,2,23,-9,38,38,0,0,100
9,1,2,23,-8,56,56,0,0,100
9,1,2,23,-7,98,98,0,0,100
9,1,2,23,-6,132,133,1,0.8,99.2
9,1,2,23,-5,214,216,2,0.9,99.1
9,1,2,23,-4,285,285,0,0,100
9,1,2,23,-3,338,358,20,5.6,94.4
9,1,2,23,-2,363,416,53,12.7,87.3
9,1,2,23,-1,288,359,71,19.8,80.2
9,1,2,23,0,266,691,425,61.5,38.5
9,1,2,123,-21,1,1,0,0,100
9,1,2,123,-19,1,1,0,0,100
9,1,2,123,-18,1,1,0,0,100
9,1,2,123,-16,1,1,0,0,100
9,1,2,123,-15,3,3,0,0,100
9,1,2,123,-14,5,5,0,0,100
9,1,2,123,-13,5,5,0,0,100
9,1,2,123,-12,11,11,0,0,100
9,1,2,123,-11,20,20,0,0,100
9,1,2,123,-10,19,19,0,0,100
9,1,2,123,-9,38,38,0,0,100
9,1,2,123,-8,65,65,0,0,100
9,1,2,123,-7,100,100,0,0,100
9,1,2,123,-6,129,131,2,1.5,98.5
9,1,2,123,-5,210,215,5,2.3,97.7
9,1,2,123,-4,296,306,10,3.3,96.7
9,1,2,123,-3,341,370,29,7.8,92.2
9,1,2,123,-2,394,470,76,16.2,83.8
9,1,2,123,-1,478,623,145,23.3,76.7
9,1,2,123,0,477,1246,769,61.7,38.3
10,0,0,0,-6,1,1,0,0,100
10,0,0,0,-5,2,2,0,0,100
10,0,0,0,-4,7,7,0,0,100
10,0,0,0,-3,17,17,0,0,100
10,0,0,0,-2,44,48,4,8.3,91.7
10,0,0,0,-1,231,282,51,18.1,81.9
10,0,0,0,0,6140,12008,5868,48.9,51.1
10,0,0,1,-4,3,3,0,0,100
10,0,0,1,-3,8,8,0,0,100
10,0,0,1,-2,19,19,0,0,100
10,0,0,1,-1,88,104,16,15.4,84.6
10,0,0,1,0,1815,3087,1272,41.2,58.8
10,0,0,2,-6,1,1,0,0,100
10,0,0,2,-5,1,1,0,0,100
10,0,0,2,-4,4,4,0,0,100
10,0,0,2,-3,9,9,0,0,100
10,0,0,2,-2,14,15,1,6.7,93.3
10,0,0,2,-1,70,75,5,6.7,93.3
10,0,0,2,0,459,672,213,31.7,68.3
10,0,0,12,-8,1,1,0,0,100
10,0,0,12,-7,1,1,0,0,100
10,0,0,12,-5,2,2,0,0,100
10,0,0,12,-4,5,5,0,0,100
10,0,0,12,-3,10,10,0,0,100
10,0,0,12,-2,12,12,0,0,100
10,0,0,12,-1,52,53,1,1.9,98.1
10,0,0,12,0,360,479,119,24.8,75.2
10,0,0,3,-3,1,1,0,0,100
10,0,0,3,-2,3,3,0,0,100
10,0,0,3,-1,19,19,0,0,100
10,0,0,3,0,74,103,29,28.2,71.8
10,0,0,13,-6,1,1,0,0,100
10,0,0,13,-4,1,1,0,0,100
10,0,0,13,-3,4,4,0,0,100
10,0,0,13,-2,14,14,0,0,100
10,0,0,13,-1,43,45,2,4.4,95.6
10,0,0,13,0,154,197,43,21.8,78.2
10,0,0,23,-5,2,2,0,0,100
10,0,0,23,-4,1,1,0,0,100
10,0,0,23,-3,3,3,0,0,100
10,0,0,23,-2,13,13,0,0,100
10,0,0,23,-1,32,33,1,3,97
10,0,0,23,0,56,66,10,15.2,84.8
10,0,0,123,-5,1,1,0,0,100
10,0,0,123,-4,2,2,0,0,100
10,0,0,123,-3,5,5,0,0,100
10,0,0,123,-2,17,17,0,0,100
10,0,0,123,-1,42,43,1,2.3,97.7
10,0,0,123,0,98,117,19,16.2,83.8
10,0,1,0,-8,1,1,0,0,100
10,0,1,0,-7,2,2,0,0,100
10,0,1,0,-6,10,10,0,0,100
10,0,1,0,-5,8,8,0,0,100
10,0,1,0,-4,33,33,0,0,100
10,0,1,0,-3,67,67,0,0,100
10,0,1,0,-2,146,157,11,7,93
10,0,1,0,-1,335,417,82,19.7,80.3
10,0,1,0,0,3738,8137,4399,54.1,45.9
10,0,1,1,-8,1,1,0,0,100
10,0,1,1,-7,1,1,0,0,100
10,0,1,1,-6,5,5,0,0,100
10,0,1,1,-5,3,3,0,0,100
10,0,1,1,-4,18,18,0,0,100
10,0,1,1,-3,46,47,1,2.1,97.9
10,0,1,1,-2,97,102,5,4.9,95.1
10,0,1,1,-1,211,262,51,19.5,80.5
10,0,1,1,0,1588,3151,1563,49.6,50.4
10,0,1,2,-7,1,1,0,0,100
10,0,1,2,-6,3,3,0,0,100
10,0,1,2,-5,3,3,0,0,100
10,0,1,2,-4,18,18,0,0,100
10,0,1,2,-3,33,34,1,2.9,97.1
10,0,1,2,-2,70,76,6,7.9,92.1
10,0,1,2,-1,233,260,27,10.4,89.6
10,0,1,2,0,1038,1806,768,42.5,57.5
10,0,1,12,-10,1,1,0,0,100
10,0,1,12,-9,1,1,0,0,100
10,0,1,12,-8,3,3,0,0,100
10,0,1,12,-7,2,2,0,0,100
10,0,1,12,-5,3,3,0,0,100
10,0,1,12,-4,16,16,0,0,100
10,0,1,12,-3,35,38,3,7.9,92.1
10,0,1,12,-2,90,96,6,6.2,93.8
10,0,1,12,-1,241,268,27,10.1,89.9
10,0,1,12,0,710,1191,481,40.4,59.6
10,0,1,3,-5,3,4,1,25,75
10,0,1,3,-4,9,9,0,0,100
10,0,1,3,-3,18,18,0,0,100
10,0,1,3,-2,33,36,3,8.3,91.7
10,0,1,3,-1,82,89,7,7.9,92.1
10,0,1,3,0,245,369,124,33.6,66.4
10,0,1,13,-7,1,1,0,0,100
10,0,1,13,-6,1,1,0,0,100
10,0,1,13,-5,7,7,0,0,100
10,0,1,13,-4,14,14,0,0,100
10,0,1,13,-3,30,30,0,0,100
10,0,1,13,-2,64,68,4,5.9,94.1
10,0,1,13,-1,124,143,19,13.3,86.7
10,0,1,13,0,342,487,145,29.8,70.2
10,0,1,23,-7,1,1,0,0,100
10,0,1,23,-6,2,2,0,0,100
10,0,1,23,-5,6,6,0,0,100
10,0,1,23,-4,5,5,0,0,100
10,0,1,23,-3,18,18,0,0,100
10,0,1,23,-2,59,61,2,3.3,96.7
10,0,1,23,-1,111,122,11,9,91
10,0,1,23,0,182,257,75,29.2,70.8
10,0,1,123,-11,1,1,0,0,100
10,0,1,123,-10,1,1,0,0,100
10,0,1,123,-8,1,1,0,0,100
10,0,1,123,-5,2,2,0,0,100
10,0,1,123,-4,6,6,0,0,100
10,0,1,123,-3,30,31,1,3.2,96.8
10,0,1,123,-2,69,72,3,4.2,95.8
10,0,1,123,-1,145,160,15,9.4,90.6
10,0,1,123,0,284,395,111,28.1,71.9
10,0,2,0,-8,3,3,0,0,100
10,0,2,0,-7,7,7,0,0,100
10,0,2,0,-6,18,18,0,0,100
10,0,2,0,-5,21,21,0,0,100
10,0,2,0,-4,49,52,3,5.8,94.2
10,0,2,0,-3,109,111,2,1.8,98.2
10,0,2,0,-2,202,216,14,6.5,93.5
10,0,2,0,-1,389,488,99,20.3,79.7
10,0,2,0,0,2430,5786,3356,58,42
10,0,2,1,-9,1,1,0,0,100
10,0,2,1,-8,2,2,0,0,100
10,0,2,1,-7,3,3,0,0,100
10,0,2,1,-6,9,9,0,0,100
10,0,2,1,-5,19,19,0,0,100
10,0,2,1,-4,42,44,2,4.5,95.5
10,0,2,1,-3,97,98,1,1,99
10,0,2,1,-2,166,176,10,5.7,94.3
10,0,2,1,-1,338,416,78,18.8,81.2
10,0,2,1,0,1258,2793,1535,55,45
10,0,2,2,-8,1,1,0,0,100
10,0,2,2,-6,12,12,0,0,100
10,0,2,2,-5,16,16,0,0,100
10,0,2,2,-4,43,44,1,2.3,97.7
10,0,2,2,-3,71,74,3,4.1,95.9
10,0,2,2,-2,158,171,13,7.6,92.4
10,0,2,2,-1,343,405,62,15.3,84.7
10,0,2,2,0,767,1495,728,48.7,51.3
10,0,2,12,-9,2,2,0,0,100
10,0,2,12,-8,1,1,0,0,100
10,0,2,12,-7,2,2,0,0,100
10,0,2,12,-6,4,4,0,0,100
10,0,2,12,-5,13,13,0,0,100
10,0,2,12,-4,36,36,0,0,100
10,0,2,12,-3,78,82,4,4.9,95.1
10,0,2,12,-2,170,178,8,4.5,95.5
10,0,2,12,-1,337,408,71,17.4,82.6
10,0,2,12,0,670,1369,699,51.1,48.9
10,0,2,3,-7,1,1,0,0,100
10,0,2,3,-6,1,1,0,0,100
10,0,2,3,-5,4,5,1,20,80
10,0,2,3,-4,24,24,0,0,100
10,0,2,3,-3,26,28,2,7.1,92.9
10,0,2,3,-2,61,65,4,6.2,93.8
10,0,2,3,-1,103,119,16,13.4,86.6
10,0,2,3,0,226,482,256,53.1,46.9
10,0,2,13,-8,2,2,0,0,100
10,0,2,13,-5,7,7,0,0,100
10,0,2,13,-4,29,29,0,0,100
10,0,2,13,-3,45,45,0,0,100
10,0,2,13,-2,88,97,9,9.3,90.7
10,0,2,13,-1,202,231,29,12.6,87.4
10,0,2,13,0,275,559,284,50.8,49.2
10,0,2,23,-7,2,2,0,0,100
10,0,2,23,-6,1,1,0,0,100
10,0,2,23,-5,9,9,0,0,100
10,0,2,23,-4,11,11,0,0,100
10,0,2,23,-3,28,30,2,6.7,93.3
10,0,2,23,-2,72,75,3,4,96
10,0,2,23,-1,141,159,18,11.3,88.7
10,0,2,23,0,137,259,122,47.1,52.9
10,0,2,123,-7,1,1,0,0,100
10,0,2,123,-6,1,1,0,0,100
10,0,2,123,-5,5,5,0,0,100
10,0,2,123,-4,7,8,1,12.5,87.5
10,0,2,123,-3,38,41,3,7.3,92.7
10,0,2,123,-2,86,91,5,5.5,94.5
10,0,2,123,-1,189,221,32,14.5,85.5
10,0,2,123,0,226,420,194,46.2,53.8
10,1,0,0,-11,1,1,0,0,100
10,1,0,0,-9,3,3,0,0,100
10,1,0,0,-8,6,6,0,0,100
10,1,0,0,-7,11,11,0,0,100
10,1,0,0,-6,31,31,0,0,100
10,1,0,0,-5,70,71,1,1.4,98.6
10,1,0,0,-4,161,165,4,2.4,97.6
10,1,0,0,-3,353,367,14,3.8,96.2
10,1,0,0,-2,699,746,47,6.3,93.7
10,1,0,0,-1,1364,1682,318,18.9,81.1
10,1,0,0,0,3475,8993,5518,61.4,38.6
10,1,0,1,-11,1,1,0,0,100
10,1,0,1,-9,1,1,0,0,100
10,1,0,1,-8,1,1,0,0,100
10,1,0,1,-7,4,4,0,0,100
10,1,0,1,-6,9,9,0,0,100
10,1,0,1,-5,15,15,0,0,100
10,1,0,1,-4,38,41,3,7.3,92.7
10,1,0,1,-3,79,88,9,10.2,89.8
10,1,0,1,-2,162,187,25,13.4,86.6
10,1,0,1,-1,306,450,144,32,68
10,1,0,1,0,776,2438,1662,68.2,31.8
10,1,0,2,-8,1,1,0,0,100
10,1,0,2,-7,1,1,0,0,100
10,1,0,2,-6,2,2,0,0,100
10,1,0,2,-5,5,5,0,0,100
10,1,0,2,-4,13,13,0,0,100
10,1,0,2,-3,29,31,2,6.5,93.5
10,1,0,2,-2,24,32,8,25,75
10,1,0,2,-1,45,74,29,39.2,60.8
10,1,0,2,0,119,500,381,76.2,23.8
10,1,0,12,-11,1,1,0,0,100
10,1,0,12,-8,1,1,0,0,100
10,1,0,12,-7,2,2,0,0,100
10,1,0,12,-6,5,5,0,0,100
10,1,0,12,-5,2,2,0,0,100
10,1,0,12,-4,10,12,2,16.7,83.3
10,1,0,12,-3,21,25,4,16,84
10,1,0,12,-2,39,51,12,23.5,76.5
10,1,0,12,-1,31,74,43,58.1,41.9
10,1,0,12,0,91,462,371,80.3,19.7
10,1,0,3,-4,1,1,0,0,100
10,1,0,3,-3,3,3,0,0,100
10,1,0,3,-2,2,2,0,0,100
10,1,0,3,-1,11,19,8,42.1,57.9
10,1,0,3,0,21,85,64,75.3,24.7
10,1,0,13,-5,2,2,0,0,100
10,1,0,13,-4,4,4,0,0,100
10,1,0,13,-3,3,4,1,25,75
10,1,0,13,-2,5,9,4,44.4,55.6
10,1,0,13,-1,12,23,11,47.8,52.2
10,1,0,13,0,36,160,124,77.5,22.5
10,1,0,23,-4,3,3,0,0,100
10,1,0,23,-3,1,2,1,50,50
10,1,0,23,-2,3,6,3,50,50
10,1,0,23,-1,8,14,6,42.9,57.1
10,1,0,23,0,8,65,57,87.7,12.3
10,1,0,123,-7,1,1,0,0,100
10,1,0,123,-6,2,2,0,0,100
10,1,0,123,-5,1,1,0,0,100
10,1,0,123,-4,1,1,0,0,100
10,1,0,123,-3,5,7,2,28.6,71.4
10,1,0,123,-2,10,15,5,33.3,66.7
10,1,0,123,-1,11,24,13,54.2,45.8
10,1,0,123,0,32,222,190,85.6,14.4
10,1,1,0,-9,2,2,0,0,100
10,1,1,0,-8,4,4,0,0,100
10,1,1,0,-7,7,7,0,0,100
10,1,1,0,-6,19,19,0,0,100
10,1,1,0,-5,52,53,1,1.9,98.1
10,1,1,0,-4,113,114,1,0.9,99.1
10,1,1,0,-3,245,248,3,1.2,98.8
10,1,1,0,-2,517,532,15,2.8,97.2
10,1,1,0,-1,1031,1160,129,11.1,88.9
10,1,1,0,0,2653,6039,3386,56.1,43.9
10,1,1,1,-9,1,1,0,0,100
10,1,1,1,-8,1,1,0,0,100
10,1,1,1,-7,3,3,0,0,100
10,1,1,1,-6,8,8,0,0,100
10,1,1,1,-5,23,23,0,0,100
10,1,1,1,-4,45,46,1,2.2,97.8
10,1,1,1,-3,100,103,3,2.9,97.1
10,1,1,1,-2,201,211,10,4.7,95.3
10,1,1,1,-1,347,440,93,21.1,78.9
10,1,1,1,0,913,2382,1469,61.7,38.3
10,1,1,2,-8,1,1,0,0,100
10,1,1,2,-7,2,2,0,0,100
10,1,1,2,-6,1,1,0,0,100
10,1,1,2,-5,7,7,0,0,100
10,1,1,2,-4,11,12,1,8.3,91.7
10,1,1,2,-3,47,51,4,7.8,92.2
10,1,1,2,-2,49,55,6,10.9,89.1
10,1,1,2,-1,201,265,64,24.2,75.8
10,1,1,2,0,500,1527,1027,67.3,32.7
10,1,1,12,-11,1,1,0,0,100
10,1,1,12,-8,1,1,0,0,100
10,1,1,12,-7,1,1,0,0,100
10,1,1,12,-6,3,3,0,0,100
10,1,1,12,-5,10,10,0,0,100
10,1,1,12,-4,17,17,0,0,100
10,1,1,12,-3,32,38,6,15.8,84.2
10,1,1,12,-2,72,81,9,11.1,88.9
10,1,1,12,-1,107,162,55,34,66
10,1,1,12,0,398,1254,856,68.3,31.7
10,1,1,3,-4,6,6,0,0,100
10,1,1,3,-3,14,15,1,6.7,93.3
10,1,1,3,-2,11,13,2,15.4,84.6
10,1,1,3,-1,30,46,16,34.8,65.2
10,1,1,3,0,64,271,207,76.4,23.6
10,1,1,13,-8,1,1,0,0,100
10,1,1,13,-6,2,2,0,0,100
10,1,1,13,-5,1,1,0,0,100
10,1,1,13,-4,6,8,2,25,75
10,1,1,13,-3,10,13,3,23.1,76.9
10,1,1,13,-2,13,21,8,38.1,61.9
10,1,1,13,-1,27,61,34,55.7,44.3
10,1,1,13,0,98,436,338,77.5,22.5
10,1,1,23,-8,1,1,0,0,100
10,1,1,23,-6,3,3,0,0,100
10,1,1,23,-5,1,1,0,0,100
10,1,1,23,-4,6,6,0,0,100
10,1,1,23,-3,7,7,0,0,100
10,1,1,23,-2,15,19,4,21.1,78.9
10,1,1,23,-1,26,59,33,55.9,44.1
10,1,1,23,0,55,281,226,80.4,19.6
10,1,1,123,-5,4,4,0,0,100
10,1,1,123,-4,3,3,0,0,100
10,1,1,123,-3,9,10,1,10,90
10,1,1,123,-2,16,19,3,15.8,84.2
10,1,1,123,-1,31,70,39,55.7,44.3
10,1,1,123,0,134,684,550,80.4,19.6
10,1,2,0,-9,2,2,0,0,100
10,1,2,0,-8,4,4,0,0,100
10,1,2,0,-7,4,4,0,0,100
10,1,2,0,-6,16,16,0,0,100
10,1,2,0,-5,35,36,1,2.8,97.2
10,1,2,0,-4,82,82,0,0,100
10,1,2,0,-3,182,183,1,0.5,99.5
10,1,2,0,-2,408,415,7,1.7,98.3
10,1,2,0,-1,808,847,39,4.6,95.4
10,1,2,0,0,2057,4237,2180,51.5,48.5
10,1,2,1,-8,1,1,0,0,100
10,1,2,1,-7,4,4,0,0,100
10,1,2,1,-6,10,10,0,0,100
10,1,2,1,-5,23,24,1,4.2,95.8
10,1,2,1,-4,41,41,0,0,100
10,1,2,1,-3,95,96,1,1,99
10,1,2,1,-2,202,209,7,3.3,96.7
10,1,2,1,-1,393,430,37,8.6,91.4
10,1,2,1,0,932,2072,1140,55,45
10,1,2,2,-8,1,1,0,0,100
10,1,2,2,-7,2,2,0,0,100
10,1,2,2,-5,9,9,0,0,100
10,1,2,2,-4,19,19,0,0,100
10,1,2,2,-3,49,49,0,0,100
10,1,2,2,-2,93,96,3,3.1,96.9
10,1,2,2,-1,195,227,32,14.1,85.9
10,1,2,2,0,464,1059,595,56.2,43.8
10,1,2,12,-11,1,1,0,0,100
10,1,2,12,-10,1,1,0,0,100
10,1,2,12,-8,1,1,0,0,100
10,1,2,12,-7,2,2,0,0,100
10,1,2,12,-6,2,2,0,0,100
10,1,2,12,-5,8,8,0,0,100
10,1,2,12,-4,17,17,0,0,100
10,1,2,12,-3,41,42,1,2.4,97.6
10,1,2,12,-2,89,93,4,4.3,95.7
10,1,2,12,-1,172,202,30,14.9,85.1
10,1,2,12,0,569,1321,752,56.9,43.1
10,1,2,3,-7,1,1,0,0,100
10,1,2,3,-5,2,2,0,0,100
10,1,2,3,-4,4,4,0,0,100
10,1,2,3,-3,23,23,0,0,100
10,1,2,3,-2,25,25,0,0,100
10,1,2,3,-1,62,71,9,12.7,87.3
10,1,2,3,0,119,310,191,61.6,38.4
10,1,2,13,-7,1,1,0,0,100
10,1,2,13,-6,2,2,0,0,100
10,1,2,13,-5,1,2,1,50,50
10,1,2,13,-4,3,3,0,0,100
10,1,2,13,-3,15,16,1,6.2,93.8
10,1,2,13,-2,39,41,2,4.9,95.1
10,1,2,13,-1,65,78,13,16.7,83.3
10,1,2,13,0,178,470,292,62.1,37.9
10,1,2,23,-8,1,1,0,0,100
10,1,2,23,-7,1,1,0,0,100
10,1,2,23,-6,2,2,0,0,100
10,1,2,23,-5,3,4,1,25,75
10,1,2,23,-4,7,7,0,0,100
10,1,2,23,-3,9,9,0,0,100
10,1,2,23,-2,18,19,1,5.3,94.7
10,1,2,23,-1,29,38,9,23.7,76.3
10,1,2,23,0,128,308,180,58.4,41.6
10,1,2,123,-8,1,1,0,0,100
10,1,2,123,-7,1,1,0,0,100
10,1,2,123,-5,4,5,1,20,80
10,1,2,123,-4,7,8,1,12.5,87.5
10,1,2,123,-3,13,15,2,13.3,86.7
10,1,2,123,-2,29,32,3,9.4,90.6
10,1,2,123,-1,58,74,16,21.6,78.4
10,1,2,123,0,232,632,400,63.3,36.7
11,0,0,0,-5,1,1,0,0,100
11,0,0,0,-4,3,4,1,25,75
11,0,0,0,-3,9,9,0,0,100
11,0,0,0,-2,34,34,0,0,100
11,0,0,0,-1,126,142,16,11.3,88.7
11,0,0,0,0,3426,6678,3252,48.7,51.3
11,0,0,1,-4,3,3,0,0,100
11,0,0,1,-3,3,3,0,0,100
11,0,0,1,-2,10,11,1,9.1,90.9
11,0,0,1,-1,48,55,7,12.7,87.3
11,0,0,1,0,1007,1741,734,42.2,57.8
11,0,0,2,-5,1,1,0,0,100
11,0,0,2,-4,1,1,0,0,100
11,0,0,2,-3,2,2,0,0,100
11,0,0,2,-2,9,11,2,18.2,81.8
11,0,0,2,-1,33,37,4,10.8,89.2
11,0,0,2,0,278,368,90,24.5,75.5
11,0,0,12,-3,1,1,0,0,100
11,0,0,12,-2,6,7,1,14.3,85.7
11,0,0,12,-1,26,30,4,13.3,86.7
11,0,0,12,0,180,257,77,30,70
11,0,0,3,-4,1,1,0,0,100
11,0,0,3,-3,2,2,0,0,100
11,0,0,3,-2,1,1,0,0,100
11,0,0,3,-1,12,12,0,0,100
11,0,0,3,0,42,54,12,22.2,77.8
11,0,0,13,-4,2,2,0,0,100
11,0,0,13,-3,1,1,0,0,100
11,0,0,13,-2,5,5,0,0,100
11,0,0,13,-1,18,20,2,10,90
11,0,0,13,0,86,107,21,19.6,80.4
11,0,0,23,-4,1,1,0,0,100
11,0,0,23,-3,4,5,1,20,80
11,0,0,23,-2,4,4,0,0,100
11,0,0,23,-1,20,21,1,4.8,95.2
11,0,0,23,0,32,41,9,22,78
11,0,0,123,-5,2,2,0,0,100
11,0,0,123,-4,2,2,0,0,100
11,0,0,123,-3,1,1,0,0,100
11,0,0,123,-2,3,3,0,0,100
11,0,0,123,-1,28,29,1,3.4,96.6
11,0,0,123,0,49,62,13,21,79
11,0,1,0,-7,1,1,0,0,100
11,0,1,0,-5,7,7,0,0,100
11,0,1,0,-4,15,16,1,6.2,93.8
11,0,1,0,-3,33,33,0,0,100
11,0,1,0,-2,80,84,4,4.8,95.2
11,0,1,0,-1,166,185,19,10.3,89.7
11,0,1,0,0,2102,4558,2456,53.9,46.1
11,0,1,1,-7,1,1,0,0,100
11,0,1,1,-6,3,3,0,0,100
11,0,1,1,-5,3,3,0,0,100
11,0,1,1,-4,11,11,0,0,100
11,0,1,1,-3,23,23,0,0,100
11,0,1,1,-2,39,43,4,9.3,90.7
11,0,1,1,-1,124,148,24,16.2,83.8
11,0,1,1,0,862,1717,855,49.8,50.2
11,0,1,2,-7,1,1,0,0,100
11,0,1,2,-5,1,1,0,0,100
11,0,1,2,-4,6,6,0,0,100
11,0,1,2,-3,18,19,1,5.3,94.7
11,0,1,2,-2,47,51,4,7.8,92.2
11,0,1,2,-1,122,144,22,15.3,84.7
11,0,1,2,0,604,1022,418,40.9,59.1
11,0,1,12,-6,2,2,0,0,100
11,0,1,12,-5,2,2,0,0,100
11,0,1,12,-4,12,12,0,0,100
11,0,1,12,-3,17,17,0,0,100
11,0,1,12,-2,40,43,3,7,93
11,0,1,12,-1,137,153,16,10.5,89.5
11,0,1,12,0,390,648,258,39.8,60.2
11,0,1,3,-6,1,1,0,0,100
11,0,1,3,-5,5,5,0,0,100
11,0,1,3,-4,4,4,0,0,100
11,0,1,3,-3,7,7,0,0,100
11,0,1,3,-2,21,22,1,4.5,95.5
11,0,1,3,-1,46,50,4,8,92
11,0,1,3,0,158,217,59,27.2,72.8
11,0,1,13,-7,1,1,0,0,100
11,0,1,13,-6,2,2,0,0,100
11,0,1,13,-5,4,4,0,0,100
11,0,1,13,-4,3,3,0,0,100
11,0,1,13,-3,16,16,0,0,100
11,0,1,13,-2,36,36,0,0,100
11,0,1,13,-1,58,68,10,14.7,85.3
11,0,1,13,0,183,252,69,27.4,72.6
11,0,1,23,-7,1,1,0,0,100
11,0,1,23,-5,1,1,0,0,100
11,0,1,23,-4,7,7,0,0,100
11,0,1,23,-3,8,9,1,11.1,88.9
11,0,1,23,-2,33,33,0,0,100
11,0,1,23,-1,66,70,4,5.7,94.3
11,0,1,23,0,130,176,46,26.1,73.9
11,0,1,123,-5,8,8,0,0,100
11,0,1,123,-4,10,10,0,0,100
11,0,1,123,-3,12,13,1,7.7,92.3
11,0,1,123,-2,39,39,0,0,100
11,0,1,123,-1,106,111,5,4.5,95.5
11,0,1,123,0,171,233,62,26.6,73.4
11,0,2,0,-8,2,2,0,0,100
11,0,2,0,-7,1,1,0,0,100
11,0,2,0,-6,8,8,0,0,100
11,0,2,0,-5,16,17,1,5.9,94.1
11,0,2,0,-4,32,33,1,3,97
11,0,2,0,-3,58,59,1,1.7,98.3
11,0,2,0,-2,120,123,3,2.4,97.6
11,0,2,0,-1,214,241,27,11.2,88.8
11,0,2,0,0,1376,3289,1913,58.2,41.8
11,0,2,1,-9,1,1,0,0,100
11,0,2,1,-8,1,1,0,0,100
11,0,2,1,-7,2,2,0,0,100
11,0,2,1,-6,10,10,0,0,100
11,0,2,1,-5,13,13,0,0,100
11,0,2,1,-4,25,26,1,3.8,96.2
11,0,2,1,-3,43,45,2,4.4,95.6
11,0,2,1,-2,85,90,5,5.6,94.4
11,0,2,1,-1,181,224,43,19.2,80.8
11,0,2,1,0,701,1575,874,55.5,44.5
11,0,2,2,-8,2,2,0,0,100
11,0,2,2,-7,2,2,0,0,100
11,0,2,2,-6,2,2,0,0,100
11,0,2,2,-5,7,7,0,0,100
11,0,2,2,-4,21,21,0,0,100
11,0,2,2,-3,45,48,3,6.2,93.8
11,0,2,2,-2,99,111,12,10.8,89.2
11,0,2,2,-1,166,193,27,14,86
11,0,2,2,0,389,793,404,50.9,49.1
11,0,2,12,-8,1,1,0,0,100
11,0,2,12,-7,2,2,0,0,100
11,0,2,12,-6,6,6,0,0,100
11,0,2,12,-5,9,9,0,0,100
11,0,2,12,-4,20,20,0,0,100
11,0,2,12,-3,40,41,1,2.4,97.6
11,0,2,12,-2,95,104,9,8.7,91.3
11,0,2,12,-1,194,229,35,15.3,84.7
11,0,2,12,0,405,796,391,49.1,50.9
11,0,2,3,-8,1,1,0,0,100
11,0,2,3,-7,2,2,0,0,100
11,0,2,3,-6,2,2,0,0,100
11,0,2,3,-5,7,7,0,0,100
11,0,2,3,-4,12,12,0,0,100
11,0,2,3,-3,19,19,0,0,100
11,0,2,3,-2,41,45,4,8.9,91.1
11,0,2,3,-1,81,92,11,12,88
11,0,2,3,0,143,279,136,48.7,51.3
11,0,2,13,-7,2,2,0,0,100
11,0,2,13,-6,5,5,0,0,100
11,0,2,13,-5,12,12,0,0,100
11,0,2,13,-4,12,12,0,0,100
11,0,2,13,-3,36,36,0,0,100
11,0,2,13,-2,69,73,4,5.5,94.5
11,0,2,13,-1,117,132,15,11.4,88.6
11,0,2,13,0,161,310,149,48.1,51.9
11,0,2,23,-7,2,2,0,0,100
11,0,2,23,-6,1,1,0,0,100
11,0,2,23,-5,1,1,0,0,100
11,0,2,23,-4,8,8,0,0,100
11,0,2,23,-3,17,18,1,5.6,94.4
11,0,2,23,-2,39,43,4,9.3,90.7
11,0,2,23,-1,75,87,12,13.8,86.2
11,0,2,23,0,70,132,62,47,53
11,0,2,123,-7,1,1,0,0,100
11,0,2,123,-5,4,4,0,0,100
11,0,2,123,-4,9,9,0,0,100
11,0,2,123,-3,13,14,1,7.1,92.9
11,0,2,123,-2,59,61,2,3.3,96.7
11,0,2,123,-1,99,116,17,14.7,85.3
11,0,2,123,0,146,272,126,46.3,53.7
11,1,0,0,-9,1,1,0,0,100
11,1,0,0,-8,5,5,0,0,100
11,1,0,0,-7,7,7,0,0,100
11,1,0,0,-6,28,28,0,0,100
11,1,0,0,-5,43,44,1,2.3,97.7
11,1,0,0,-4,86,87,1,1.1,98.9
11,1,0,0,-3,173,180,7,3.9,96.1
11,1,0,0,-2,422,450,28,6.2,93.8
11,1,0,0,-1,757,904,147,16.3,83.7
11,1,0,0,0,1925,5011,3086,61.6,38.4
11,1,0,1,-9,1,1,0,0,100
11,1,0,1,-8,3,3,0,0,100
11,1,0,1,-7,1,1,0,0,100
11,1,0,1,-6,5,5,0,0,100
11,1,0,1,-5,15,16,1,6.2,93.8
11,1,0,1,-4,31,32,1,3.1,96.9
11,1,0,1,-3,51,56,5,8.9,91.1
11,1,0,1,-2,117,133,16,12,88
11,1,0,1,-1,189,257,68,26.5,73.5
11,1,0,1,0,466,1419,953,67.2,32.8
11,1,0,2,-6,2,2,0,0,100
11,1,0,2,-5,1,1,0,0,100
11,1,0,2,-4,7,7,0,0,100
11,1,0,2,-3,8,9,1,11.1,88.9
11,1,0,2,-2,24,27,3,11.1,88.9
11,1,0,2,-1,32,53,21,39.6,60.4
11,1,0,2,0,65,291,226,77.7,22.3
11,1,0,12,-7,1,1,0,0,100
11,1,0,12,-6,1,1,0,0,100
11,1,0,12,-5,3,4,1,25,75
11,1,0,12,-4,12,13,1,7.7,92.3
11,1,0,12,-3,10,13,3,23.1,76.9
11,1,0,12,-2,34,42,8,19,81
11,1,0,12,-1,22,39,17,43.6,56.4
11,1,0,12,0,78,306,228,74.5,25.5
11,1,0,3,-5,1,1,0,0,100
11,1,0,3,-3,2,2,0,0,100
11,1,0,3,-2,4,4,0,0,100
11,1,0,3,-1,2,4,2,50,50
11,1,0,3,0,10,56,46,82.1,17.9
11,1,0,13,-9,1,1,0,0,100
11,1,0,13,-4,1,1,0,0,100
11,1,0,13,-3,1,1,0,0,100
11,1,0,13,-2,7,9,2,22.2,77.8
11,1,0,13,-1,9,17,8,47.1,52.9
11,1,0,13,0,17,104,87,83.7,16.3
11,1,0,23,-3,1,2,1,50,50
11,1,0,23,-2,8,10,2,20,80
11,1,0,23,-1,1,6,5,83.3,16.7
11,1,0,23,0,9,49,40,81.6,18.4
11,1,0,123,-7,1,1,0,0,100
11,1,0,123,-5,1,2,1,50,50
11,1,0,123,-4,3,3,0,0,100
11,1,0,123,-3,1,1,0,0,100
11,1,0,123,-2,3,5,2,40,60
11,1,0,123,-1,3,11,8,72.7,27.3
11,1,0,123,0,25,158,133,84.2,15.8
11,1,1,0,-8,2,2,0,0,100
11,1,1,0,-7,6,6,0,0,100
11,1,1,0,-6,20,20,0,0,100
11,1,1,0,-5,28,28,0,0,100
11,1,1,0,-4,53,53,0,0,100
11,1,1,0,-3,115,116,1,0.9,99.1
11,1,1,0,-2,279,288,9,3.1,96.9
11,1,1,0,-1,558,608,50,8.2,91.8
11,1,1,0,0,1426,3295,1869,56.7,43.3
11,1,1,1,-8,3,3,0,0,100
11,1,1,1,-6,7,7,0,0,100
11,1,1,1,-5,14,14,0,0,100
11,1,1,1,-4,27,27,0,0,100
11,1,1,1,-3,54,58,4,6.9,93.1
11,1,1,1,-2,111,121,10,8.3,91.7
11,1,1,1,-1,195,232,37,15.9,84.1
11,1,1,1,0,527,1376,849,61.7,38.3
11,1,1,2,-8,2,2,0,0,100
11,1,1,2,-7,1,1,0,0,100
11,1,1,2,-6,3,3,0,0,100
11,1,1,2,-5,3,3,0,0,100
11,1,1,2,-4,6,6,0,0,100
11,1,1,2,-3,16,16,0,0,100
11,1,1,2,-2,44,46,2,4.3,95.7
11,1,1,2,-1,119,148,29,19.6,80.4
11,1,1,2,0,300,868,568,65.4,34.6
11,1,1,12,-7,1,1,0,0,100
11,1,1,12,-6,1,1,0,0,100
11,1,1,12,-5,8,8,0,0,100
11,1,1,12,-4,15,15,0,0,100
11,1,1,12,-3,14,18,4,22.2,77.8
11,1,1,12,-2,45,51,6,11.8,88.2
11,1,1,12,-1,43,66,23,34.8,65.2
11,1,1,12,0,242,732,490,66.9,33.1
11,1,1,3,-8,1,1,0,0,100
11,1,1,3,-7,1,1,0,0,100
11,1,1,3,-5,1,1,0,0,100
11,1,1,3,-4,3,3,0,0,100
11,1,1,3,-3,6,7,1,14.3,85.7
11,1,1,3,-2,13,14,1,7.1,92.9
11,1,1,3,-1,15,28,13,46.4,53.6
11,1,1,3,0,35,140,105,75,25
11,1,1,13,-8,2,2,0,0,100
11,1,1,13,-5,2,2,0,0,100
11,1,1,13,-4,4,4,0,0,100
11,1,1,13,-3,6,7,1,14.3,85.7
11,1,1,13,-2,14,17,3,17.6,82.4
11,1,1,13,-1,18,33,15,45.5,54.5
11,1,1,13,0,38,228,190,83.3,16.7
11,1,1,23,-8,1,1,0,0,100
11,1,1,23,-6,2,2,0,0,100
11,1,1,23,-4,2,2,0,0,100
11,1,1,23,-3,3,3,0,0,100
11,1,1,23,-2,24,28,4,14.3,85.7
11,1,1,23,-1,17,28,11,39.3,60.7
11,1,1,23,0,41,158,117,74.1,25.9
11,1,1,123,-6,1,1,0,0,100
11,1,1,123,-5,2,2,0,0,100
11,1,1,123,-4,3,3,0,0,100
11,1,1,123,-3,1,4,3,75,25
11,1,1,123,-2,9,10,1,10,90
11,1,1,123,-1,14,28,14,50,50
11,1,1,123,0,79,361,282,78.1,21.9
11,1,2,0,-8,1,1,0,0,100
11,1,2,0,-7,6,6,0,0,100
11,1,2,0,-6,16,16,0,0,100
11,1,2,0,-5,22,22,0,0,100
11,1,2,0,-4,37,37,0,0,100
11,1,2,0,-3,92,92,0,0,100
11,1,2,0,-2,226,231,5,2.2,97.8
11,1,2,0,-1,442,455,13,2.9,97.1
11,1,2,0,0,1069,2229,1160,52,48
11,1,2,1,-7,2,2,0,0,100
11,1,2,1,-6,6,6,0,0,100
11,1,2,1,-5,12,12,0,0,100
11,1,2,1,-4,21,21,0,0,100
11,1,2,1,-3,58,58,0,0,100
11,1,2,1,-2,119,126,7,5.6,94.4
11,1,2,1,-1,243,260,17,6.5,93.5
11,1,2,1,0,550,1190,640,53.8,46.2
11,1,2,2,-8,1,1,0,0,100
11,1,2,2,-6,2,2,0,0,100
11,1,2,2,-5,5,5,0,0,100
11,1,2,2,-4,7,7,0,0,100
11,1,2,2,-3,24,24,0,0,100
11,1,2,2,-2,45,46,1,2.2,97.8
11,1,2,2,-1,119,131,12,9.2,90.8
11,1,2,2,0,232,609,377,61.9,38.1
11,1,2,12,-7,1,1,0,0,100
11,1,2,12,-6,1,1,0,0,100
11,1,2,12,-5,7,7,0,0,100
11,1,2,12,-4,12,12,0,0,100
11,1,2,12,-3,20,21,1,4.8,95.2
11,1,2,12,-2,46,50,4,8,92
11,1,2,12,-1,101,113,12,10.6,89.4
11,1,2,12,0,284,725,441,60.8,39.2
11,1,2,3,-7,2,2,0,0,100
11,1,2,3,-5,2,2,0,0,100
11,1,2,3,-4,5,5,0,0,100
11,1,2,3,-3,11,11,0,0,100
11,1,2,3,-2,15,15,0,0,100
11,1,2,3,-1,41,46,5,10.9,89.1
11,1,2,3,0,81,173,92,53.2,46.8
11,1,2,13,-6,1,1,0,0,100
11,1,2,13,-5,1,1,0,0,100
11,1,2,13,-4,2,2,0,0,100
11,1,2,13,-3,10,10,0,0,100
11,1,2,13,-2,14,16,2,12.5,87.5
11,1,2,13,-1,51,57,6,10.5,89.5
11,1,2,13,0,120,288,168,58.3,41.7
11,1,2,23,-6,1,1,0,0,100
11,1,2,23,-5,1,1,0,0,100
11,1,2,23,-4,2,2,0,0,100
11,1,2,23,-3,6,6,0,0,100
11,1,2,23,-2,11,14,3,21.4,78.6
11,1,2,23,-1,14,19,5,26.3,73.7
11,1,2,23,0,78,182,104,57.1,42.9
11,1,2,123,-7,1,1,0,0,100
11,1,2,123,-5,3,3,0,0,100
11,1,2,123,-4,1,1,0,0,100
11,1,2,123,-3,3,4,1,25,75
11,1,2,123,-2,11,13,2,15.4,84.6
11,1,2,123,-1,22,27,5,18.5,81.5
11,1,2,123,0,137,376,239,63.6,36.4
12,0,0,0,-5,1,1,0,0,100
12,0,0,0,-3,3,3,0,0,100
12,0,0,0,-2,12,13,1,7.7,92.3
12,0,0,0,-1,64,71,7,9.9,90.1
12,0,0,0,0,1892,3683,1791,48.6,51.4
12,0,0,1,-7,1,1,0,0,100
12,0,0,1,-2,9,9,0,0,100
12,0,0,1,-1,27,30,3,10,90
12,0,0,1,0,615,1047,432,41.3,58.7
12,0,0,2,-3,1,1,0,0,100
12,0,0,2,-2,8,8,0,0,100
12,0,0,2,-1,17,21,4,19,81
12,0,0,2,0,173,247,74,30,70
12,0,0,12,-7,1,1,0,0,100
12,0,0,12,-4,1,1,0,0,100
12,0,0,12,-3,2,2,0,0,100
12,0,0,12,-2,5,5,0,0,100
12,0,0,12,-1,14,15,1,6.7,93.3
12,0,0,12,0,113,160,47,29.4,70.6
12,0,0,3,-4,2,2,0,0,100
12,0,0,3,-3,1,1,0,0,100
12,0,0,3,-2,3,3,0,0,100
12,0,0,3,-1,9,9,0,0,100
12,0,0,3,0,30,39,9,23.1,76.9
12,0,0,13,-3,1,1,0,0,100
12,0,0,13,-2,7,7,0,0,100
12,0,0,13,-1,12,12,0,0,100
12,0,0,13,0,46,56,10,17.9,82.1
12,0,0,23,-5,1,1,0,0,100
12,0,0,23,-2,3,3,0,0,100
12,0,0,23,-1,10,10,0,0,100
12,0,0,23,0,24,31,7,22.6,77.4
12,0,0,123,-3,1,1,0,0,100
12,0,0,123,-2,7,7,0,0,100
12,0,0,123,-1,12,12,0,0,100
12,0,0,123,0,27,35,8,22.9,77.1
12,0,1,0,-5,4,4,0,0,100
12,0,1,0,-4,4,4,0,0,100
12,0,1,0,-3,20,20,0,0,100
12,0,1,0,-2,33,38,5,13.2,86.8
12,0,1,0,-1,100,114,14,12.3,87.7
12,0,1,0,0,1085,2398,1313,54.8,45.2
12,0,1,1,-7,1,1,0,0,100
12,0,1,1,-5,2,2,0,0,100
12,0,1,1,-4,3,3,0,0,100
12,0,1,1,-3,6,6,0,0,100
12,0,1,1,-2,25,25,0,0,100
12,0,1,1,-1,73,78,5,6.4,93.6
12,0,1,1,0,482,981,499,50.9,49.1
12,0,1,2,-5,2,2,0,0,100
12,0,1,2,-4,5,5,0,0,100
12,0,1,2,-3,4,4,0,0,100
12,0,1,2,-2,24,26,2,7.7,92.3
12,0,1,2,-1,65,74,9,12.2,87.8
12,0,1,2,0,349,571,222,38.9,61.1
12,0,1,12,-6,1,1,0,0,100
12,0,1,12,-4,5,5,0,0,100
12,0,1,12,-3,8,8,0,0,100
12,0,1,12,-2,23,25,2,8,92
12,0,1,12,-1,61,72,11,15.3,84.7
12,0,1,12,0,234,382,148,38.7,61.3
12,0,1,3,-5,1,1,0,0,100
12,0,1,3,-4,3,3,0,0,100
12,0,1,3,-3,6,6,0,0,100
12,0,1,3,-2,12,13,1,7.7,92.3
12,0,1,3,-1,28,33,5,15.2,84.8
12,0,1,3,0,78,114,36,31.6,68.4
12,0,1,13,-5,1,1,0,0,100
12,0,1,13,-3,7,7,0,0,100
12,0,1,13,-2,20,20,0,0,100
12,0,1,13,-1,35,39,4,10.3,89.7
12,0,1,13,0,98,146,48,32.9,67.1
12,0,1,23,-5,2,2,0,0,100
12,0,1,23,-4,1,1,0,0,100
12,0,1,23,-3,4,4,0,0,100
12,0,1,23,-2,20,20,0,0,100
12,0,1,23,-1,28,30,2,6.7,93.3
12,0,1,23,0,84,116,32,27.6,72.4
12,0,1,123,-4,1,1,0,0,100
12,0,1,123,-3,5,5,0,0,100
12,0,1,123,-2,31,33,2,6.1,93.9
12,0,1,123,-1,57,59,2,3.4,96.6
12,0,1,123,0,106,140,34,24.3,75.7
12,0,2,0,-8,2,2,0,0,100
12,0,2,0,-7,1,1,0,0,100
12,0,2,0,-6,3,3,0,0,100
12,0,2,0,-5,4,4,0,0,100
12,0,2,0,-4,11,11,0,0,100
12,0,2,0,-3,37,38,1,2.6,97.4
12,0,2,0,-2,59,65,6,9.2,90.8
12,0,2,0,-1,112,127,15,11.8,88.2
12,0,2,0,0,727,1740,1013,58.2,41.8
12,0,2,1,-8,1,1,0,0,100
12,0,2,1,-7,2,2,0,0,100
12,0,2,1,-6,3,3,0,0,100
12,0,2,1,-5,5,5,0,0,100
12,0,2,1,-4,12,12,0,0,100
12,0,2,1,-3,20,21,1,4.8,95.2
12,0,2,1,-2,43,45,2,4.4,95.6
12,0,2,1,-1,110,131,21,16,84
12,0,2,1,0,372,841,469,55.8,44.2
12,0,2,2,-7,2,2,0,0,100
12,0,2,2,-6,3,3,0,0,100
12,0,2,2,-5,6,6,0,0,100
12,0,2,2,-4,12,12,0,0,100
12,0,2,2,-3,20,20,0,0,100
12,0,2,2,-2,62,65,3,4.6,95.4
12,0,2,2,-1,108,134,26,19.4,80.6
12,0,2,2,0,221,449,228,50.8,49.2
12,0,2,12,-5,4,4,0,0,100
12,0,2,12,-4,16,16,0,0,100
12,0,2,12,-3,26,26,0,0,100
12,0,2,12,-2,47,50,3,6,94
12,0,2,12,-1,104,127,23,18.1,81.9
12,0,2,12,0,237,461,224,48.6,51.4
12,0,2,3,-6,3,3,0,0,100
12,0,2,3,-5,3,3,0,0,100
12,0,2,3,-4,8,9,1,11.1,88.9
12,0,2,3,-3,12,13,1,7.7,92.3
12,0,2,3,-2,15,18,3,16.7,83.3
12,0,2,3,-1,36,44,8,18.2,81.8
12,0,2,3,0,87,153,66,43.1,56.9
12,0,2,13,-6,2,2,0,0,100
12,0,2,13,-5,4,4,0,0,100
12,0,2,13,-4,3,3,0,0,100
12,0,2,13,-3,18,18,0,0,100
12,0,2,13,-2,34,34,0,0,100
12,0,2,13,-1,73,87,14,16.1,83.9
12,0,2,13,0,88,179,91,50.8,49.2
12,0,2,23,-6,1,1,0,0,100
12,0,2,23,-4,3,3,0,0,100
12,0,2,23,-3,12,12,0,0,100
12,0,2,23,-2,23,23,0,0,100
12,0,2,23,-1,37,44,7,15.9,84.1
12,0,2,23,0,52,88,36,40.9,59.1
12,0,2,123,-6,1,1,0,0,100
12,0,2,123,-5,1,1,0,0,100
12,0,2,123,-4,5,5,0,0,100
12,0,2,123,-3,16,16,0,0,100
12,0,2,123,-2,33,36,3,8.3,91.7
12,0,2,123,-1,60,72,12,16.7,83.3
12,0,2,123,0,71,134,63,47,53
12,1,0,0,-8,3,3,0,0,100
12,1,0,0,-7,4,4,0,0,100
12,1,0,0,-6,12,12,0,0,100
12,1,0,0,-5,17,17,0,0,100
12,1,0,0,-4,39,40,1,2.5,97.5
12,1,0,0,-3,117,118,1,0.8,99.2
12,1,0,0,-2,217,236,19,8.1,91.9
12,1,0,0,-1,424,516,92,17.8,82.2
12,1,0,0,0,1072,2758,1686,61.1,38.9
12,1,0,1,-7,1,1,0,0,100
12,1,0,1,-6,3,3,0,0,100
12,1,0,1,-5,7,7,0,0,100
12,1,0,1,-4,11,11,0,0,100
12,1,0,1,-3,33,34,1,2.9,97.1
12,1,0,1,-2,51,63,12,19,81
12,1,0,1,-1,83,129,46,35.7,64.3
12,1,0,1,0,259,789,530,67.2,32.8
12,1,0,2,-5,4,4,0,0,100
12,1,0,2,-4,2,2,0,0,100
12,1,0,2,-3,11,11,0,0,100
12,1,0,2,-2,13,15,2,13.3,86.7
12,1,0,2,-1,20,29,9,31,69
12,1,0,2,0,27,160,133,83.1,16.9
12,1,0,12,-7,1,1,0,0,100
12,1,0,12,-5,2,2,0,0,100
12,1,0,12,-4,2,2,0,0,100
12,1,0,12,-3,9,9,0,0,100
12,1,0,12,-2,11,18,7,38.9,61.1
12,1,0,12,-1,8,19,11,57.9,42.1
12,1,0,12,0,36,157,121,77.1,22.9
12,1,0,3,-3,1,1,0,0,100
12,1,0,3,-1,5,6,1,16.7,83.3
12,1,0,3,0,1,33,32,97,3
12,1,0,13,-3,4,4,0,0,100
12,1,0,13,-2,6,6,0,0,100
12,1,0,13,-1,3,7,4,57.1,42.9
12,1,0,13,0,7,53,46,86.8,13.2
12,1,0,23,-3,0,1,1,100,0
12,1,0,23,-1,2,4,2,50,50
12,1,0,23,0,4,18,14,77.8,22.2
12,1,0,123,-3,2,2,0,0,100
12,1,0,123,-2,1,3,2,66.7,33.3
12,1,0,123,-1,2,7,5,71.4,28.6
12,1,0,123,0,6,70,64,91.4,8.59999999999999
12,1,1,0,-8,2,2,0,0,100
12,1,1,0,-7,4,4,0,0,100
12,1,1,0,-6,9,9,0,0,100
12,1,1,0,-5,8,8,0,0,100
12,1,1,0,-4,26,27,1,3.7,96.3
12,1,1,0,-3,73,73,0,0,100
12,1,1,0,-2,156,161,5,3.1,96.9
12,1,1,0,-1,323,358,35,9.8,90.2
12,1,1,0,0,812,1823,1011,55.5,44.5
12,1,1,1,-7,1,1,0,0,100
12,1,1,1,-6,5,5,0,0,100
12,1,1,1,-5,5,5,0,0,100
12,1,1,1,-4,12,13,1,7.7,92.3
12,1,1,1,-3,34,34,0,0,100
12,1,1,1,-2,68,74,6,8.1,91.9
12,1,1,1,-1,115,148,33,22.3,77.7
12,1,1,1,0,307,754,447,59.3,40.7
12,1,1,2,-6,1,1,0,0,100
12,1,1,2,-5,3,3,0,0,100
12,1,1,2,-4,6,6,0,0,100
12,1,1,2,-3,11,11,0,0,100
12,1,1,2,-2,21,24,3,12.5,87.5
12,1,1,2,-1,49,71,22,31,69
12,1,1,2,0,148,489,341,69.7,30.3
12,1,1,12,-6,1,1,0,0,100
12,1,1,12,-5,1,1,0,0,100
12,1,1,12,-4,5,5,0,0,100
12,1,1,12,-3,14,14,0,0,100
12,1,1,12,-2,22,27,5,18.5,81.5
12,1,1,12,-1,32,47,15,31.9,68.1
12,1,1,12,0,112,415,303,73,27
12,1,1,3,-3,3,3,0,0,100
12,1,1,3,-2,5,6,1,16.7,83.3
12,1,1,3,-1,13,19,6,31.6,68.4
12,1,1,3,0,16,90,74,82.2,17.8
12,1,1,13,-5,1,1,0,0,100
12,1,1,13,-4,3,3,0,0,100
12,1,1,13,-3,2,3,1,33.3,66.7
12,1,1,13,-2,6,10,4,40,60
12,1,1,13,-1,7,18,11,61.1,38.9
12,1,1,13,0,35,139,104,74.8,25.2
12,1,1,23,-4,2,3,1,33.3,66.7
12,1,1,23,-3,3,3,0,0,100
12,1,1,23,-2,3,5,2,40,60
12,1,1,23,-1,4,13,9,69.2,30.8
12,1,1,23,0,21,100,79,79,21
12,1,1,123,-5,1,1,0,0,100
12,1,1,123,-4,2,2,0,0,100
12,1,1,123,-3,5,5,0,0,100
12,1,1,123,-2,4,6,2,33.3,66.7
12,1,1,123,-1,9,21,12,57.1,42.9
12,1,1,123,0,36,206,170,82.5,17.5
12,1,2,0,-8,1,1,0,0,100
12,1,2,0,-7,3,3,0,0,100
12,1,2,0,-6,6,6,0,0,100
12,1,2,0,-5,8,8,0,0,100
12,1,2,0,-4,22,22,0,0,100
12,1,2,0,-3,55,55,0,0,100
12,1,2,0,-2,116,118,2,1.7,98.3
12,1,2,0,-1,265,276,11,4,96
12,1,2,0,0,638,1282,644,50.2,49.8
12,1,2,1,-7,3,3,0,0,100
12,1,2,1,-6,7,7,0,0,100
12,1,2,1,-5,4,4,0,0,100
12,1,2,1,-4,13,13,0,0,100
12,1,2,1,-3,26,26,0,0,100
12,1,2,1,-2,65,67,2,3,97
12,1,2,1,-1,131,143,12,8.4,91.6
12,1,2,1,0,304,640,336,52.5,47.5
12,1,2,2,-8,1,1,0,0,100
12,1,2,2,-5,3,3,0,0,100
12,1,2,2,-4,3,3,0,0,100
12,1,2,2,-3,10,10,0,0,100
12,1,2,2,-2,25,25,0,0,100
12,1,2,2,-1,51,60,9,15,85
12,1,2,2,0,149,350,201,57.4,42.6
12,1,2,12,-7,1,1,0,0,100
12,1,2,12,-6,2,2,0,0,100
12,1,2,12,-5,2,2,0,0,100
12,1,2,12,-4,7,7,0,0,100
12,1,2,12,-3,16,16,0,0,100
12,1,2,12,-2,21,23,2,8.7,91.3
12,1,2,12,-1,50,59,9,15.3,84.7
12,1,2,12,0,155,409,254,62.1,37.9
12,1,2,3,-7,1,1,0,0,100
12,1,2,3,-6,2,2,0,0,100
12,1,2,3,-5,1,1,0,0,100
12,1,2,3,-4,1,1,0,0,100
12,1,2,3,-3,3,3,0,0,100
12,1,2,3,-2,6,6,0,0,100
12,1,2,3,-1,24,32,8,25,75
12,1,2,3,0,37,104,67,64.4,35.6
12,1,2,13,-8,1,1,0,0,100
12,1,2,13,-7,1,1,0,0,100
12,1,2,13,-6,1,1,0,0,100
12,1,2,13,-4,3,3,0,0,100
12,1,2,13,-3,2,2,0,0,100
12,1,2,13,-2,12,12,0,0,100
12,1,2,13,-1,13,17,4,23.5,76.5
12,1,2,13,0,63,150,87,58,42
12,1,2,23,-6,1,1,0,0,100
12,1,2,23,-4,5,5,0,0,100
12,1,2,23,-3,4,4,0,0,100
12,1,2,23,-2,4,5,1,20,80
12,1,2,23,-1,8,8,0,0,100
12,1,2,23,0,41,110,69,62.7,37.3
12,1,2,123,-6,1,1,0,0,100
12,1,2,123,-4,3,3,0,0,100
12,1,2,123,-3,5,5,0,0,100
12,1,2,123,-2,6,6,0,0,100
12,1,2,123,-1,10,13,3,23.1,76.9
12,1,2,123,0,66,199,133,66.8,33.2
13,0,0,0,-6,1,1,0,0,100
13,0,0,0,-4,2,2,0,0,100
13,0,0,0,-3,2,2,0,0,100
13,0,0,0,-2,13,15,2,13.3,86.7
13,0,0,0,-1,35,43,8,18.6,81.4
13,0,0,0,0,1066,2057,991,48.2,51.8
13,0,0,1,-4,2,2,0,0,100
13,0,0,1,-2,3,4,1,25,75
13,0,0,1,-1,9,12,3,25,75
13,0,0,1,0,336,554,218,39.4,60.6
13,0,0,2,-2,3,3,0,0,100
13,0,0,2,-1,12,12,0,0,100
13,0,0,2,0,72,112,40,35.7,64.3
13,0,0,12,-4,2,2,0,0,100
13,0,0,12,-3,1,1,0,0,100
13,0,0,12,-2,4,4,0,0,100
13,0,0,12,-1,9,9,0,0,100
13,0,0,12,0,39,66,27,40.9,59.1
13,0,0,3,-2,3,3,0,0,100
13,0,0,3,-1,6,6,0,0,100
13,0,0,3,0,14,19,5,26.3,73.7
13,0,0,13,-3,1,1,0,0,100
13,0,0,13,-2,3,3,0,0,100
13,0,0,13,-1,5,6,1,16.7,83.3
13,0,0,13,0,31,36,5,13.9,86.1
13,0,0,23,-4,1,1,0,0,100
13,0,0,23,-1,5,5,0,0,100
13,0,0,23,0,16,18,2,11.1,88.9
13,0,0,123,-2,2,2,0,0,100
13,0,0,123,-1,12,13,1,7.7,92.3
13,0,0,123,0,16,18,2,11.1,88.9
13,0,1,0,-6,2,2,0,0,100
13,0,1,0,-5,1,1,0,0,100
13,0,1,0,-4,3,3,0,0,100
13,0,1,0,-3,11,11,0,0,100
13,0,1,0,-2,29,31,2,6.5,93.5
13,0,1,0,-1,54,68,14,20.6,79.4
13,0,1,0,0,636,1378,742,53.8,46.2
13,0,1,1,-6,1,1,0,0,100
13,0,1,1,-5,1,1,0,0,100
13,0,1,1,-4,1,1,0,0,100
13,0,1,1,-3,4,4,0,0,100
13,0,1,1,-2,15,16,1,6.2,93.8
13,0,1,1,-1,35,45,10,22.2,77.8
13,0,1,1,0,281,532,251,47.2,52.8
13,0,1,2,-6,1,1,0,0,100
13,0,1,2,-4,1,1,0,0,100
13,0,1,2,-3,11,11,0,0,100
13,0,1,2,-2,14,14,0,0,100
13,0,1,2,-1,27,35,8,22.9,77.1
13,0,1,2,0,194,328,134,40.9,59.1
13,0,1,12,-5,1,1,0,0,100
13,0,1,12,-4,2,2,0,0,100
13,0,1,12,-3,4,4,0,0,100
13,0,1,12,-2,15,16,1,6.2,93.8
13,0,1,12,-1,31,37,6,16.2,83.8
13,0,1,12,0,127,221,94,42.5,57.5
13,0,1,3,-5,2,2,0,0,100
13,0,1,3,-4,1,1,0,0,100
13,0,1,3,-3,5,5,0,0,100
13,0,1,3,-2,4,4,0,0,100
13,0,1,3,-1,11,12,1,8.3,91.7
13,0,1,3,0,42,63,21,33.3,66.7
13,0,1,13,-5,2,2,0,0,100
13,0,1,13,-3,5,5,0,0,100
13,0,1,13,-2,12,13,1,7.7,92.3
13,0,1,13,-1,18,20,2,10,90
13,0,1,13,0,48,72,24,33.3,66.7
13,0,1,23,-4,5,5,0,0,100
13,0,1,23,-3,4,4,0,0,100
13,0,1,23,-2,5,6,1,16.7,83.3
13,0,1,23,-1,22,26,4,15.4,84.6
13,0,1,23,0,31,45,14,31.1,68.9
13,0,1,123,-4,1,1,0,0,100
13,0,1,123,-3,3,3,0,0,100
13,0,1,123,-2,12,14,2,14.3,85.7
13,0,1,123,-1,20,25,5,20,80
13,0,1,123,0,48,62,14,22.6,77.4
13,0,2,0,-9,1,1,0,0,100
13,0,2,0,-8,1,1,0,0,100
13,0,2,0,-6,2,2,0,0,100
13,0,2,0,-5,8,8,0,0,100
13,0,2,0,-4,10,10,0,0,100
13,0,2,0,-3,15,15,0,0,100
13,0,2,0,-2,38,42,4,9.5,90.5
13,0,2,0,-1,77,90,13,14.4,85.6
13,0,2,0,0,417,995,578,58.1,41.9
13,0,2,1,-8,1,1,0,0,100
13,0,2,1,-6,3,3,0,0,100
13,0,2,1,-5,3,3,0,0,100
13,0,2,1,-4,3,3,0,0,100
13,0,2,1,-3,19,19,0,0,100
13,0,2,1,-2,24,28,4,14.3,85.7
13,0,2,1,-1,73,91,18,19.8,80.2
13,0,2,1,0,211,474,263,55.5,44.5
13,0,2,2,-8,1,1,0,0,100
13,0,2,2,-6,2,2,0,0,100
13,0,2,2,-5,5,5,0,0,100
13,0,2,2,-4,6,6,0,0,100
13,0,2,2,-3,17,17,0,0,100
13,0,2,2,-2,27,32,5,15.6,84.4
13,0,2,2,-1,40,50,10,20,80
13,0,2,2,0,121,232,111,47.8,52.2
13,0,2,12,-8,1,1,0,0,100
13,0,2,12,-6,3,3,0,0,100
13,0,2,12,-5,4,4,0,0,100
13,0,2,12,-4,5,5,0,0,100
13,0,2,12,-3,11,12,1,8.3,91.7
13,0,2,12,-2,28,30,2,6.7,93.3
13,0,2,12,-1,62,73,11,15.1,84.9
13,0,2,12,0,143,244,101,41.4,58.6
13,0,2,3,-5,3,3,0,0,100
13,0,2,3,-4,5,5,0,0,100
13,0,2,3,-3,8,8,0,0,100
13,0,2,3,-2,16,16,0,0,100
13,0,2,3,-1,11,20,9,45,55
13,0,2,3,0,48,97,49,50.5,49.5
13,0,2,13,-7,1,1,0,0,100
13,0,2,13,-6,1,1,0,0,100
13,0,2,13,-5,2,2,0,0,100
13,0,2,13,-4,2,2,0,0,100
13,0,2,13,-3,6,6,0,0,100
13,0,2,13,-2,16,19,3,15.8,84.2
13,0,2,13,-1,29,37,8,21.6,78.4
13,0,2,13,0,53,98,45,45.9,54.1
13,0,2,23,-4,5,5,0,0,100
13,0,2,23,-3,7,8,1,12.5,87.5
13,0,2,23,-2,9,9,0,0,100
13,0,2,23,-1,32,38,6,15.8,84.2
13,0,2,23,0,24,54,30,55.6,44.4
13,0,2,123,-5,1,1,0,0,100
13,0,2,123,-3,5,5,0,0,100
13,0,2,123,-2,16,18,2,11.1,88.9
13,0,2,123,-1,35,41,6,14.6,85.4
13,0,2,123,0,50,83,33,39.8,60.2
13,1,0,0,-9,1,1,0,0,100
13,1,0,0,-8,1,1,0,0,100
13,1,0,0,-7,1,1,0,0,100
13,1,0,0,-6,7,7,0,0,100
13,1,0,0,-5,16,16,0,0,100
13,1,0,0,-4,28,28,0,0,100
13,1,0,0,-3,49,51,2,3.9,96.1
13,1,0,0,-2,122,137,15,10.9,89.1
13,1,0,0,-1,230,294,64,21.8,78.2
13,1,0,0,0,619,1535,916,59.7,40.3
13,1,0,1,-8,1,1,0,0,100
13,1,0,1,-6,3,3,0,0,100
13,1,0,1,-5,3,3,0,0,100
13,1,0,1,-4,4,4,0,0,100
13,1,0,1,-3,16,17,1,5.9,94.1
13,1,0,1,-2,31,40,9,22.5,77.5
13,1,0,1,-1,56,84,28,33.3,66.7
13,1,0,1,0,133,419,286,68.3,31.7
13,1,0,2,-6,1,1,0,0,100
13,1,0,2,-3,2,2,0,0,100
13,1,0,2,-2,3,6,3,50,50
13,1,0,2,-1,8,19,11,57.9,42.1
13,1,0,2,0,22,97,75,77.3,22.7
13,1,0,12,-5,1,1,0,0,100
13,1,0,12,-4,1,1,0,0,100
13,1,0,12,-3,2,2,0,0,100
13,1,0,12,-2,9,10,1,10,90
13,1,0,12,-1,6,16,10,62.5,37.5
13,1,0,12,0,16,84,68,81,19
13,1,0,3,-4,1,1,0,0,100
13,1,0,3,-1,2,3,1,33.3,66.7
13,1,0,3,0,2,14,12,85.7,14.3
13,1,0,13,-3,2,2,0,0,100
13,1,0,13,-2,1,3,2,66.7,33.3
13,1,0,13,-1,0,7,7,100,0
13,1,0,13,0,6,36,30,83.3,16.7
13,1,0,23,-3,2,2,0,0,100
13,1,0,23,-2,1,2,1,50,50
13,1,0,23,0,1,15,14,93.3,6.69999999999999
13,1,0,123,-4,1,1,0,0,100
13,1,0,123,-2,2,2,0,0,100
13,1,0,123,-1,0,4,4,100,0
13,1,0,123,0,2,46,44,95.7,4.3
13,1,1,0,-9,1,1,0,0,100
13,1,1,0,-7,1,1,0,0,100
13,1,1,0,-6,3,3,0,0,100
13,1,1,0,-5,13,13,0,0,100
13,1,1,0,-4,24,24,0,0,100
13,1,1,0,-3,32,33,1,3,97
13,1,1,0,-2,85,88,3,3.4,96.6
13,1,1,0,-1,171,194,23,11.9,88.1
13,1,1,0,0,476,1022,546,53.4,46.6
13,1,1,1,-6,4,4,0,0,100
13,1,1,1,-5,7,7,0,0,100
13,1,1,1,-4,8,8,0,0,100
13,1,1,1,-3,18,20,2,10,90
13,1,1,1,-2,30,35,5,14.3,85.7
13,1,1,1,-1,61,81,20,24.7,75.3
13,1,1,1,0,176,411,235,57.2,42.8
13,1,1,2,-8,1,1,0,0,100
13,1,1,2,-6,2,2,0,0,100
13,1,1,2,-5,1,1,0,0,100
13,1,1,2,-4,2,2,0,0,100
13,1,1,2,-3,5,5,0,0,100
13,1,1,2,-2,8,11,3,27.3,72.7
13,1,1,2,-1,27,39,12,30.8,69.2
13,1,1,2,0,83,255,172,67.5,32.5
13,1,1,12,-5,1,1,0,0,100
13,1,1,12,-4,2,2,0,0,100
13,1,1,12,-3,8,10,2,20,80
13,1,1,12,-2,9,11,2,18.2,81.8
13,1,1,12,-1,17,32,15,46.9,53.1
13,1,1,12,0,66,208,142,68.3,31.7
13,1,1,3,-4,1,1,0,0,100
13,1,1,3,-2,1,1,0,0,100
13,1,1,3,-1,9,14,5,35.7,64.3
13,1,1,3,0,6,35,29,82.9,17.1
13,1,1,13,-8,1,1,0,0,100
13,1,1,13,-4,1,1,0,0,100
13,1,1,13,-3,2,2,0,0,100
13,1,1,13,-2,1,2,1,50,50
13,1,1,13,-1,7,11,4,36.4,63.6
13,1,1,13,0,11,54,43,79.6,20.4
13,1,1,23,-5,1,1,0,0,100
13,1,1,23,-4,1,1,0,0,100
13,1,1,23,-3,1,1,0,0,100
13,1,1,23,-2,3,5,2,40,60
13,1,1,23,-1,6,10,4,40,60
13,1,1,23,0,5,40,35,87.5,12.5
13,1,1,123,-8,1,1,0,0,100
13,1,1,123,-4,2,2,0,0,100
13,1,1,123,-3,3,4,1,25,75
13,1,1,123,-2,2,4,2,50,50
13,1,1,123,-1,5,13,8,61.5,38.5
13,1,1,123,0,13,106,93,87.7,12.3
13,1,2,0,-9,1,1,0,0,100
13,1,2,0,-7,1,1,0,0,100
13,1,2,0,-6,1,1,0,0,100
13,1,2,0,-5,7,7,0,0,100
13,1,2,0,-4,17,17,0,0,100
13,1,2,0,-3,20,20,0,0,100
13,1,2,0,-2,69,69,0,0,100
13,1,2,0,-1,139,146,7,4.8,95.2
13,1,2,0,0,369,722,353,48.9,51.1
13,1,2,1,-6,5,5,0,0,100
13,1,2,1,-5,5,5,0,0,100
13,1,2,1,-4,9,9,0,0,100
13,1,2,1,-3,14,14,0,0,100
13,1,2,1,-2,34,34,0,0,100
13,1,2,1,-1,77,86,9,10.5,89.5
13,1,2,1,0,181,367,186,50.7,49.3
13,1,2,2,-6,1,1,0,0,100
13,1,2,2,-5,5,5,0,0,100
13,1,2,2,-4,3,3,0,0,100
13,1,2,2,-3,5,5,0,0,100
13,1,2,2,-2,18,18,0,0,100
13,1,2,2,-1,28,32,4,12.5,87.5
13,1,2,2,0,72,195,123,63.1,36.9
13,1,2,12,-6,2,2,0,0,100
13,1,2,12,-5,3,3,0,0,100
13,1,2,12,-4,2,2,0,0,100
13,1,2,12,-3,6,7,1,14.3,85.7
13,1,2,12,-2,17,17,0,0,100
13,1,2,12,-1,27,32,5,15.6,84.4
13,1,2,12,0,80,231,151,65.4,34.6
13,1,2,3,-4,1,1,0,0,100
13,1,2,3,-2,5,6,1,16.7,83.3
13,1,2,3,-1,12,15,3,20,80
13,1,2,3,0,22,60,38,63.3,36.7
13,1,2,13,-4,2,2,0,0,100
13,1,2,13,-3,4,4,0,0,100
13,1,2,13,-2,7,9,2,22.2,77.8
13,1,2,13,-1,11,16,5,31.2,68.8
13,1,2,13,0,32,75,43,57.3,42.7
13,1,2,23,-5,3,3,0,0,100
13,1,2,23,-4,1,1,0,0,100
13,1,2,23,-3,1,1,0,0,100
13,1,2,23,-2,3,3,0,0,100
13,1,2,23,-1,3,4,1,25,75
13,1,2,23,0,14,38,24,63.2,36.8
13,1,2,123,-4,1,1,0,0,100
13,1,2,123,-3,2,2,0,0,100
13,1,2,123,-2,4,5,1,20,80
13,1,2,123,-1,8,14,6,42.9,57.1
13,1,2,123,0,32,104,72,69.2,30.8
14,0,0,0,-5,1,1,0,0,100
14,0,0,0,-2,6,6,0,0,100
14,0,0,0,-1,27,28,1,3.6,96.4
14,0,0,0,0,615,1163,548,47.1,52.9
14,0,0,1,-5,1,1,0,0,100
14,0,0,1,-4,1,1,0,0,100
14,0,0,1,-2,5,5,0,0,100
14,0,0,1,-1,6,7,1,14.3,85.7
14,0,0,1,0,174,295,121,41,59
14,0,0,2,-6,1,1,0,0,100
14,0,0,2,-2,1,1,0,0,100
14,0,0,2,-1,7,7,0,0,100
14,0,0,2,0,47,74,27,36.5,63.5
14,0,0,12,-4,1,1,0,0,100
14,0,0,12,-2,4,5,1,20,80
14,0,0,12,-1,10,11,1,9.1,90.9
14,0,0,12,0,35,47,12,25.5,74.5
14,0,0,3,-3,2,2,0,0,100
14,0,0,3,-1,2,2,0,0,100
14,0,0,3,0,2,6,4,66.7,33.3
14,0,0,13,-2,1,1,0,0,100
14,0,0,13,-1,1,1,0,0,100
14,0,0,13,0,17,23,6,26.1,73.9
14,0,0,23,-4,1,1,0,0,100
14,0,0,23,-3,1,1,0,0,100
14,0,0,23,-1,4,4,0,0,100
14,0,0,23,0,4,6,2,33.3,66.7
14,0,0,123,-2,3,3,0,0,100
14,0,0,123,-1,5,5,0,0,100
14,0,0,123,0,7,10,3,30,70
14,0,1,0,-7,1,1,0,0,100
14,0,1,0,-4,2,2,0,0,100
14,0,1,0,-3,4,4,0,0,100
14,0,1,0,-2,12,13,1,7.7,92.3
14,0,1,0,-1,30,31,1,3.2,96.8
14,0,1,0,0,376,790,414,52.4,47.6
14,0,1,1,-5,1,1,0,0,100
14,0,1,1,-4,1,1,0,0,100
14,0,1,1,-3,5,5,0,0,100
14,0,1,1,-2,5,5,0,0,100
14,0,1,1,-1,15,17,2,11.8,88.2
14,0,1,1,0,162,298,136,45.6,54.4
14,0,1,2,-6,1,1,0,0,100
14,0,1,2,-5,2,2,0,0,100
14,0,1,2,-4,1,1,0,0,100
14,0,1,2,-3,3,3,0,0,100
14,0,1,2,-2,9,9,0,0,100
14,0,1,2,-1,22,24,2,8.3,91.7
14,0,1,2,0,105,176,71,40.3,59.7
14,0,1,12,-4,2,2,0,0,100
14,0,1,12,-3,5,5,0,0,100
14,0,1,12,-2,9,10,1,10,90
14,0,1,12,-1,22,29,7,24.1,75.9
14,0,1,12,0,81,122,41,33.6,66.4
14,0,1,3,-5,1,1,0,0,100
14,0,1,3,-3,1,1,0,0,100
14,0,1,3,-2,3,4,1,25,75
14,0,1,3,-1,5,5,0,0,100
14,0,1,3,0,25,43,18,41.9,58.1
14,0,1,13,-6,1,1,0,0,100
14,0,1,13,-5,1,1,0,0,100
14,0,1,13,-4,1,1,0,0,100
14,0,1,13,-3,2,2,0,0,100
14,0,1,13,-2,6,7,1,14.3,85.7
14,0,1,13,-1,16,18,2,11.1,88.9
14,0,1,13,0,36,56,20,35.7,64.3
14,0,1,23,-4,1,1,0,0,100
14,0,1,23,-3,3,3,0,0,100
14,0,1,23,-2,6,6,0,0,100
14,0,1,23,-1,13,14,1,7.1,92.9
14,0,1,23,0,20,29,9,31,69
14,0,1,123,-4,2,2,0,0,100
14,0,1,123,-3,1,1,0,0,100
14,0,1,123,-2,10,10,0,0,100
14,0,1,123,-1,22,23,1,4.3,95.7
14,0,1,123,0,30,40,10,25,75
14,0,2,0,-7,2,2,0,0,100
14,0,2,0,-5,2,2,0,0,100
14,0,2,0,-4,5,5,0,0,100
14,0,2,0,-3,9,10,1,10,90
14,0,2,0,-2,20,22,2,9.1,90.9
14,0,2,0,-1,36,37,1,2.7,97.3
14,0,2,0,0,243,562,319,56.8,43.2
14,0,2,1,-7,1,1,0,0,100
14,0,2,1,-5,1,1,0,0,100
14,0,2,1,-4,5,5,0,0,100
14,0,2,1,-3,10,10,0,0,100
14,0,2,1,-2,17,17,0,0,100
14,0,2,1,-1,33,36,3,8.3,91.7
14,0,2,1,0,140,271,131,48.3,51.7
14,0,2,2,-6,2,2,0,0,100
14,0,2,2,-5,3,3,0,0,100
14,0,2,2,-4,5,5,0,0,100
14,0,2,2,-3,8,9,1,11.1,88.9
14,0,2,2,-2,16,17,1,5.9,94.1
14,0,2,2,-1,34,39,5,12.8,87.2
14,0,2,2,0,72,155,83,53.5,46.5
14,0,2,12,-6,2,2,0,0,100
14,0,2,12,-5,2,2,0,0,100
14,0,2,12,-4,6,6,0,0,100
14,0,2,12,-3,6,8,2,25,75
14,0,2,12,-2,12,13,1,7.7,92.3
14,0,2,12,-1,34,41,7,17.1,82.9
14,0,2,12,0,59,126,67,53.2,46.8
14,0,2,3,-5,1,1,0,0,100
14,0,2,3,-4,2,2,0,0,100
14,0,2,3,-3,7,7,0,0,100
14,0,2,3,-2,5,6,1,16.7,83.3
14,0,2,3,-1,12,13,1,7.7,92.3
14,0,2,3,0,22,42,20,47.6,52.4
14,0,2,13,-6,1,1,0,0,100
14,0,2,13,-5,2,2,0,0,100
14,0,2,13,-4,3,3,0,0,100
14,0,2,13,-3,4,4,0,0,100
14,0,2,13,-2,7,8,1,12.5,87.5
14,0,2,13,-1,16,20,4,20,80
14,0,2,13,0,42,71,29,40.8,59.2
14,0,2,23,-5,1,1,0,0,100
14,0,2,23,-4,1,1,0,0,100
14,0,2,23,-3,3,3,0,0,100
14,0,2,23,-2,7,8,1,12.5,87.5
14,0,2,23,-1,18,19,1,5.3,94.7
14,0,2,23,0,16,32,16,50,50
14,0,2,123,-6,1,1,0,0,100
14,0,2,123,-5,1,1,0,0,100
14,0,2,123,-4,1,1,0,0,100
14,0,2,123,-3,3,3,0,0,100
14,0,2,123,-2,8,10,2,20,80
14,0,2,123,-1,26,29,3,10.3,89.7
14,0,2,123,0,22,43,21,48.8,51.2
14,1,0,0,-7,3,3,0,0,100
14,1,0,0,-6,3,3,0,0,100
14,1,0,0,-5,12,12,0,0,100
14,1,0,0,-4,17,17,0,0,100
14,1,0,0,-3,31,34,3,8.8,91.2
14,1,0,0,-2,66,74,8,10.8,89.2
14,1,0,0,-1,146,169,23,13.6,86.4
14,1,0,0,0,338,852,514,60.3,39.7
14,1,0,1,-7,1,1,0,0,100
14,1,0,1,-5,3,3,0,0,100
14,1,0,1,-4,6,6,0,0,100
14,1,0,1,-3,9,12,3,25,75
14,1,0,1,-2,9,14,5,35.7,64.3
14,1,0,1,-1,42,56,14,25,75
14,1,0,1,0,86,256,170,66.4,33.6
14,1,0,2,-5,1,1,0,0,100
14,1,0,2,-3,2,2,0,0,100
14,1,0,2,-2,1,1,0,0,100
14,1,0,2,-1,9,12,3,25,75
14,1,0,2,0,6,45,39,86.7,13.3
14,1,0,12,-7,1,1,0,0,100
14,1,0,12,-3,2,2,0,0,100
14,1,0,12,-2,5,6,1,16.7,83.3
14,1,0,12,-1,4,9,5,55.6,44.4
14,1,0,12,0,12,48,36,75,25
14,1,0,3,-1,3,3,0,0,100
14,1,0,3,0,2,8,6,75,25
14,1,0,13,-1,4,5,1,20,80
14,1,0,13,0,2,13,11,84.6,15.4
14,1,0,23,-3,1,1,0,0,100
14,1,0,23,-2,1,1,0,0,100
14,1,0,23,-1,0,2,2,100,0
14,1,0,23,0,3,8,5,62.5,37.5
14,1,0,123,-3,1,1,0,0,100
14,1,0,123,-2,3,3,0,0,100
14,1,0,123,-1,1,5,4,80,20
14,1,0,123,0,2,21,19,90.5,9.5
14,1,1,0,-7,2,2,0,0,100
14,1,1,0,-6,2,2,0,0,100
14,1,1,0,-5,8,8,0,0,100
14,1,1,0,-4,11,11,0,0,100
14,1,1,0,-3,19,19,0,0,100
14,1,1,0,-2,56,59,3,5.1,94.9
14,1,1,0,-1,96,104,8,7.7,92.3
14,1,1,0,0,256,560,304,54.3,45.7
14,1,1,1,-6,1,1,0,0,100
14,1,1,1,-5,5,5,0,0,100
14,1,1,1,-4,8,8,0,0,100
14,1,1,1,-3,8,11,3,27.3,72.7
14,1,1,1,-2,22,28,6,21.4,78.6
14,1,1,1,-1,29,36,7,19.4,80.6
14,1,1,1,0,96,235,139,59.1,40.9
14,1,1,2,-4,1,1,0,0,100
14,1,1,2,-3,1,1,0,0,100
14,1,1,2,-2,4,5,1,20,80
14,1,1,2,-1,30,33,3,9.1,90.9
14,1,1,2,0,53,152,99,65.1,34.9
14,1,1,12,-5,1,1,0,0,100
14,1,1,12,-4,3,3,0,0,100
14,1,1,12,-3,2,4,2,50,50
14,1,1,12,-2,4,7,3,42.9,57.1
14,1,1,12,-1,9,13,4,30.8,69.2
14,1,1,12,0,47,139,92,66.2,33.8
14,1,1,3,-5,1,1,0,0,100
14,1,1,3,-3,1,1,0,0,100
14,1,1,3,-1,5,8,3,37.5,62.5
14,1,1,3,0,10,32,22,68.8,31.2
14,1,1,13,-3,0,1,1,100,0
14,1,1,13,-2,1,2,1,50,50
14,1,1,13,-1,4,6,2,33.3,66.7
14,1,1,13,0,13,43,30,69.8,30.2
14,1,1,23,-3,1,1,0,0,100
14,1,1,23,-2,1,4,3,75,25
14,1,1,23,-1,2,5,3,60,40
14,1,1,23,0,7,32,25,78.1,21.9
14,1,1,123,-5,1,1,0,0,100
14,1,1,123,-4,2,2,0,0,100
14,1,1,123,-3,1,3,2,66.7,33.3
14,1,1,123,-2,1,4,3,75,25
14,1,1,123,-1,3,6,3,50,50
14,1,1,123,0,13,66,53,80.3,19.7
14,1,2,0,-7,2,2,0,0,100
14,1,2,0,-6,1,1,0,0,100
14,1,2,0,-5,6,6,0,0,100
14,1,2,0,-4,9,9,0,0,100
14,1,2,0,-3,17,17,0,0,100
14,1,2,0,-2,37,37,0,0,100
14,1,2,0,-1,71,73,2,2.7,97.3
14,1,2,0,0,199,399,200,50.1,49.9
14,1,2,1,-6,2,2,0,0,100
14,1,2,1,-5,6,6,0,0,100
14,1,2,1,-4,4,4,0,0,100
14,1,2,1,-3,13,13,0,0,100
14,1,2,1,-2,20,20,0,0,100
14,1,2,1,-1,34,37,3,8.1,91.9
14,1,2,1,0,98,205,107,52.2,47.8
14,1,2,2,-7,1,1,0,0,100
14,1,2,2,-4,3,3,0,0,100
14,1,2,2,-3,2,2,0,0,100
14,1,2,2,-2,9,9,0,0,100
14,1,2,2,-1,25,26,1,3.8,96.2
14,1,2,2,0,38,106,68,64.2,35.8
14,1,2,12,-4,3,3,0,0,100
14,1,2,12,-3,3,3,0,0,100
14,1,2,12,-2,7,8,1,12.5,87.5
14,1,2,12,-1,12,13,1,7.7,92.3
14,1,2,12,0,62,138,76,55.1,44.9
14,1,2,3,-7,1,1,0,0,100
14,1,2,3,-5,1,1,0,0,100
14,1,2,3,-2,3,3,0,0,100
14,1,2,3,-1,9,10,1,10,90
14,1,2,3,0,14,31,17,54.8,45.2
14,1,2,13,-5,1,1,0,0,100
14,1,2,13,-2,2,2,0,0,100
14,1,2,13,-1,4,7,3,42.9,57.1
14,1,2,13,0,23,49,26,53.1,46.9
14,1,2,23,-3,3,3,0,0,100
14,1,2,23,-2,1,1,0,0,100
14,1,2,23,-1,1,3,2,66.7,33.3
14,1,2,23,0,8,34,26,76.5,23.5
14,1,2,123,-4,1,1,0,0,100
14,1,2,123,-3,1,1,0,0,100
14,1,2,123,-2,2,3,1,33.3,66.7
14,1,2,123,-1,3,6,3,50,50
14,1,2,123,0,25,63,38,60.3,39.7
15,0,0,0,-2,1,1,0,0,100
15,0,0,0,-1,9,10,1,10,90
15,0,0,0,0,335,622,287,46.1,53.9
15,0,0,1,-1,3,3,0,0,100
15,0,0,1,0,111,171,60,35.1,64.9
15,0,0,2,-1,3,3,0,0,100
15,0,0,2,0,30,39,9,23.1,76.9
15,0,0,12,-2,1,1,0,0,100
15,0,0,12,-1,3,3,0,0,100
15,0,0,12,0,25,33,8,24.2,75.8
15,0,0,3,-2,1,1,0,0,100
15,0,0,3,-1,2,2,0,0,100
15,0,0,3,0,5,5,0,0,100
15,0,0,13,-2,1,1,0,0,100
15,0,0,13,0,9,13,4,30.8,69.2
15,0,0,23,0,4,5,1,20,80
15,0,0,123,-1,1,1,0,0,100
15,0,0,123,0,5,6,1,16.7,83.3
15,0,1,0,-4,2,2,0,0,100
15,0,1,0,-3,3,3,0,0,100
15,0,1,0,-2,9,9,0,0,100
15,0,1,0,-1,14,16,2,12.5,87.5
15,0,1,0,0,193,412,219,53.2,46.8
15,0,1,1,-3,2,2,0,0,100
15,0,1,1,-2,5,5,0,0,100
15,0,1,1,-1,9,10,1,10,90
15,0,1,1,0,84,159,75,47.2,52.8
15,0,1,2,-10,1,1,0,0,100
15,0,1,2,-4,1,1,0,0,100
15,0,1,2,-3,1,1,0,0,100
15,0,1,2,-2,4,4,0,0,100
15,0,1,2,-1,10,10,0,0,100
15,0,1,2,0,61,91,30,33,67
15,0,1,12,-8,1,1,0,0,100
15,0,1,12,-4,1,1,0,0,100
15,0,1,12,-2,8,8,0,0,100
15,0,1,12,-1,12,13,1,7.7,92.3
15,0,1,12,0,42,62,20,32.3,67.7
15,0,1,3,-5,1,1,0,0,100
15,0,1,3,-3,1,1,0,0,100
15,0,1,3,-1,6,6,0,0,100
15,0,1,3,0,13,15,2,13.3,86.7
15,0,1,13,-7,1,1,0,0,100
15,0,1,13,-6,1,1,0,0,100
15,0,1,13,-3,3,3,0,0,100
15,0,1,13,-2,4,4,0,0,100
15,0,1,13,-1,9,10,1,10,90
15,0,1,13,0,21,28,7,25,75
15,0,1,23,-3,2,2,0,0,100
15,0,1,23,-2,4,4,0,0,100
15,0,1,23,-1,4,4,0,0,100
15,0,1,23,0,14,21,7,33.3,66.7
15,0,1,123,-4,1,1,0,0,100
15,0,1,123,-3,1,1,0,0,100
15,0,1,123,-2,2,2,0,0,100
15,0,1,123,-1,7,7,0,0,100
15,0,1,123,0,23,31,8,25.8,74.2
15,0,2,0,-6,2,2,0,0,100
15,0,2,0,-4,2,2,0,0,100
15,0,2,0,-3,4,4,0,0,100
15,0,2,0,-2,8,8,0,0,100
15,0,2,0,-1,18,20,2,10,90
15,0,2,0,0,127,302,175,57.9,42.1
15,0,2,1,-12,1,1,0,0,100
15,0,2,1,-5,2,2,0,0,100
15,0,2,1,-4,2,2,0,0,100
15,0,2,1,-3,5,6,1,16.7,83.3
15,0,2,1,-2,10,11,1,9.1,90.9
15,0,2,1,-1,13,16,3,18.8,81.2
15,0,2,1,0,66,147,81,55.1,44.9
15,0,2,2,-11,1,1,0,0,100
15,0,2,2,-10,1,1,0,0,100
15,0,2,2,-4,2,2,0,0,100
15,0,2,2,-3,4,6,2,33.3,66.7
15,0,2,2,-2,8,10,2,20,80
15,0,2,2,-1,17,19,2,10.5,89.5
15,0,2,2,0,37,74,37,50,50
15,0,2,12,-3,2,3,1,33.3,66.7
15,0,2,12,-2,6,6,0,0,100
15,0,2,12,-1,24,25,1,4,96
15,0,2,12,0,39,78,39,50,50
15,0,2,3,-5,2,2,0,0,100
15,0,2,3,-4,1,1,0,0,100
15,0,2,3,-3,2,2,0,0,100
15,0,2,3,-2,3,3,0,0,100
15,0,2,3,-1,5,5,0,0,100
15,0,2,3,0,14,24,10,41.7,58.3
15,0,2,13,-5,1,1,0,0,100
15,0,2,13,-4,1,1,0,0,100
15,0,2,13,-3,4,5,1,20,80
15,0,2,13,-2,8,9,1,11.1,88.9
15,0,2,13,-1,12,17,5,29.4,70.6
15,0,2,13,0,18,31,13,41.9,58.1
15,0,2,23,-3,1,1,0,0,100
15,0,2,23,-2,7,7,0,0,100
15,0,2,23,-1,9,13,4,30.8,69.2
15,0,2,23,0,17,23,6,26.1,73.9
15,0,2,123,-3,1,1,0,0,100
15,0,2,123,-2,7,7,0,0,100
15,0,2,123,-1,11,15,4,26.7,73.3
15,0,2,123,0,17,26,9,34.6,65.4
15,1,0,0,-12,1,1,0,0,100
15,1,0,0,-6,2,2,0,0,100
15,1,0,0,-5,5,5,0,0,100
15,1,0,0,-4,4,4,0,0,100
15,1,0,0,-3,20,22,2,9.1,90.9
15,1,0,0,-2,41,44,3,6.8,93.2
15,1,0,0,-1,65,77,12,15.6,84.4
15,1,0,0,0,197,467,270,57.8,42.2
15,1,0,1,-5,1,1,0,0,100
15,1,0,1,-4,1,1,0,0,100
15,1,0,1,-3,7,8,1,12.5,87.5
15,1,0,1,-2,9,12,3,25,75
15,1,0,1,-1,16,20,4,20,80
15,1,0,1,0,50,142,92,64.8,35.2
15,1,0,2,-4,1,1,0,0,100
15,1,0,2,-1,2,6,4,66.7,33.3
15,1,0,2,0,10,25,15,60,40
15,1,0,12,-3,3,3,0,0,100
15,1,0,12,-2,0,2,2,100,0
15,1,0,12,-1,0,2,2,100,0
15,1,0,12,0,3,16,13,81.2,18.8
15,1,0,3,0,2,9,7,77.8,22.2
15,1,0,13,-1,1,1,0,0,100
15,1,0,13,0,1,10,9,90,10
15,1,0,23,-5,1,1,0,0,100
15,1,0,23,-3,0,1,1,100,0
15,1,0,23,-2,0,1,1,100,0
15,1,0,23,0,2,5,3,60,40
15,1,0,123,-5,1,1,0,0,100
15,1,0,123,-3,1,1,0,0,100
15,1,0,123,-1,0,1,1,100,0
15,1,0,123,0,1,12,11,91.7,8.3
15,1,1,0,-12,1,1,0,0,100
15,1,1,0,-6,2,2,0,0,100
15,1,1,0,-5,4,4,0,0,100
15,1,1,0,-4,2,2,0,0,100
15,1,1,0,-3,13,14,1,7.1,92.9
15,1,1,0,-2,32,32,0,0,100
15,1,1,0,-1,48,52,4,7.7,92.3
15,1,1,0,0,144,301,157,52.2,47.8
15,1,1,1,-6,2,2,0,0,100
15,1,1,1,-4,2,2,0,0,100
15,1,1,1,-3,8,8,0,0,100
15,1,1,1,-2,16,17,1,5.9,94.1
15,1,1,1,-1,19,20,1,5,95
15,1,1,1,0,48,118,70,59.3,40.7
15,1,1,2,-6,1,1,0,0,100
15,1,1,2,-5,1,1,0,0,100
15,1,1,2,-4,1,1,0,0,100
15,1,1,2,-3,1,1,0,0,100
15,1,1,2,-2,5,5,0,0,100
15,1,1,2,-1,9,12,3,25,75
15,1,1,2,0,43,96,53,55.2,44.8
15,1,1,12,-3,6,6,0,0,100
15,1,1,12,-2,6,7,1,14.3,85.7
15,1,1,12,-1,6,7,1,14.3,85.7
15,1,1,12,0,30,71,41,57.7,42.3
15,1,1,3,-2,0,1,1,100,0
15,1,1,3,-1,1,3,2,66.7,33.3
15,1,1,3,0,4,15,11,73.3,26.7
15,1,1,13,-2,1,1,0,0,100
15,1,1,13,-1,1,2,1,50,50
15,1,1,13,0,7,24,17,70.8,29.2
15,1,1,23,-4,1,1,0,0,100
15,1,1,23,-2,1,1,0,0,100
15,1,1,23,0,2,4,2,50,50
15,1,1,123,-5,1,1,0,0,100
15,1,1,123,-3,1,1,0,0,100
15,1,1,123,-2,2,2,0,0,100
15,1,1,123,-1,0,1,1,100,0
15,1,1,123,0,11,25,14,56,44
15,1,2,0,-12,1,1,0,0,100
15,1,2,0,-5,3,3,0,0,100
15,1,2,0,-4,1,1,0,0,100
15,1,2,0,-3,7,8,1,12.5,87.5
15,1,2,0,-2,22,22,0,0,100
15,1,2,0,-1,39,42,3,7.1,92.9
15,1,2,0,0,111,226,115,50.9,49.1
15,1,2,1,-6,1,1,0,0,100
15,1,2,1,-5,1,1,0,0,100
15,1,2,1,-4,1,1,0,0,100
15,1,2,1,-3,7,8,1,12.5,87.5
15,1,2,1,-2,13,14,1,7.1,92.9
15,1,2,1,-1,21,24,3,12.5,87.5
15,1,2,1,0,55,112,57,50.9,49.1
15,1,2,2,-6,1,1,0,0,100
15,1,2,2,-5,1,1,0,0,100
15,1,2,2,-4,1,1,0,0,100
15,1,2,2,-3,1,1,0,0,100
15,1,2,2,-2,5,5,0,0,100
15,1,2,2,-1,8,10,2,20,80
15,1,2,2,0,22,54,32,59.3,40.7
15,1,2,12,-6,1,1,0,0,100
15,1,2,12,-5,1,1,0,0,100
15,1,2,12,-3,5,6,1,16.7,83.3
15,1,2,12,-2,5,6,1,16.7,83.3
15,1,2,12,-1,11,12,1,8.3,91.7
15,1,2,12,0,27,71,44,62,38
15,1,2,3,-1,5,7,2,28.6,71.4
15,1,2,3,0,10,23,13,56.5,43.5
15,1,2,13,-2,1,2,1,50,50
15,1,2,13,-1,3,6,3,50,50
15,1,2,13,0,17,36,19,52.8,47.2
15,1,2,23,-4,1,1,0,0,100
15,1,2,23,-3,1,1,0,0,100
15,1,2,23,-2,2,3,1,33.3,66.7
15,1,2,23,-1,3,3,0,0,100
15,1,2,23,0,4,22,18,81.8,18.2
15,1,2,123,-5,1,1,0,0,100
15,1,2,123,-3,1,1,0,0,100
15,1,2,123,-2,2,3,1,33.3,66.7
15,1,2,123,-1,1,2,1,50,50
15,1,2,123,0,17,39,22,56.4,43.6
16,0,0,0,-3,2,2,0,0,100
16,0,0,0,-2,1,1,0,0,100
16,0,0,0,-1,4,4,0,0,100
16,0,0,0,0,184,347,163,47,53
16,0,0,1,-2,1,1,0,0,100
16,0,0,1,-1,1,2,1,50,50
16,0,0,1,0,46,79,33,41.8,58.2
16,0,0,2,0,11,16,5,31.2,68.8
16,0,0,12,-3,1,1,0,0,100
16,0,0,12,-2,1,1,0,0,100
16,0,0,12,-1,0,2,2,100,0
16,0,0,12,0,11,13,2,15.4,84.6
16,0,0,3,0,4,4,0,0,100
16,0,0,13,0,4,5,1,20,80
16,0,0,23,-1,1,1,0,0,100
16,0,0,23,0,2,3,1,33.3,66.7
16,0,0,123,-4,1,1,0,0,100
16,0,0,123,-3,1,1,0,0,100
16,0,0,123,-1,2,2,0,0,100
16,0,0,123,0,3,3,0,0,100
16,0,1,0,-3,3,3,0,0,100
16,0,1,0,-2,1,1,0,0,100
16,0,1,0,-1,11,12,1,8.3,91.7
16,0,1,0,0,124,252,128,50.8,49.2
16,0,1,1,-2,1,1,0,0,100
16,0,1,1,-1,7,8,1,12.5,87.5
16,0,1,1,0,43,82,39,47.6,52.4
16,0,1,2,-4,1,1,0,0,100
16,0,1,2,-3,1,1,0,0,100
16,0,1,2,-2,1,1,0,0,100
16,0,1,2,-1,4,7,3,42.9,57.1
16,0,1,2,0,29,52,23,44.2,55.8
16,0,1,12,-4,1,1,0,0,100
16,0,1,12,-2,3,3,0,0,100
16,0,1,12,-1,9,10,1,10,90
16,0,1,12,0,20,31,11,35.5,64.5
16,0,1,3,-5,1,1,0,0,100
16,0,1,3,-4,1,1,0,0,100
16,0,1,3,-3,1,1,0,0,100
16,0,1,3,-2,2,2,0,0,100
16,0,1,3,-1,1,1,0,0,100
16,0,1,3,0,6,7,1,14.3,85.7
16,0,1,13,-5,1,1,0,0,100
16,0,1,13,-3,1,1,0,0,100
16,0,1,13,-2,1,1,0,0,100
16,0,1,13,-1,3,4,1,25,75
16,0,1,13,0,11,19,8,42.1,57.9
16,0,1,23,-2,1,1,0,0,100
16,0,1,23,-1,1,2,1,50,50
16,0,1,23,0,10,12,2,16.7,83.3
16,0,1,123,-2,1,1,0,0,100
16,0,1,123,-1,5,6,1,16.7,83.3
16,0,1,123,0,9,11,2,18.2,81.8
16,0,2,0,-3,2,2,0,0,100
16,0,2,0,-2,2,2,0,0,100
16,0,2,0,-1,8,8,0,0,100
16,0,2,0,0,85,186,101,54.3,45.7
16,0,2,1,-4,1,1,0,0,100
16,0,2,1,-3,3,3,0,0,100
16,0,2,1,-2,2,2,0,0,100
16,0,2,1,-1,13,14,1,7.1,92.9
16,0,2,1,0,43,97,54,55.7,44.3
16,0,2,2,-5,1,1,0,0,100
16,0,2,2,-4,1,1,0,0,100
16,0,2,2,-3,2,2,0,0,100
16,0,2,2,-2,5,5,0,0,100
16,0,2,2,-1,7,11,4,36.4,63.6
16,0,2,2,0,22,39,17,43.6,56.4
16,0,2,12,-5,1,1,0,0,100
16,0,2,12,-4,1,1,0,0,100
16,0,2,12,-3,2,2,0,0,100
16,0,2,12,-2,9,9,0,0,100
16,0,2,12,-1,15,17,2,11.8,88.2
16,0,2,12,0,17,37,20,54.1,45.9
16,0,2,3,-5,1,1,0,0,100
16,0,2,3,-4,1,1,0,0,100
16,0,2,3,-3,2,2,0,0,100
16,0,2,3,-2,3,3,0,0,100
16,0,2,3,-1,3,4,1,25,75
16,0,2,3,0,4,7,3,42.9,57.1
16,0,2,13,-5,1,1,0,0,100
16,0,2,13,-4,1,1,0,0,100
16,0,2,13,-3,2,2,0,0,100
16,0,2,13,-2,7,7,0,0,100
16,0,2,13,-1,6,7,1,14.3,85.7
16,0,2,13,0,7,14,7,50,50
16,0,2,23,-4,1,1,0,0,100
16,0,2,23,-2,4,5,1,20,80
16,0,2,23,-1,3,3,0,0,100
16,0,2,23,0,3,5,2,40,60
16,0,2,123,-2,2,2,0,0,100
16,0,2,123,-1,1,1,0,0,100
16,0,2,123,0,9,16,7,43.8,56.2
16,1,0,0,-5,5,5,0,0,100
16,1,0,0,-4,3,3,0,0,100
16,1,0,0,-3,10,10,0,0,100
16,1,0,0,-2,19,20,1,5,95
16,1,0,0,-1,36,45,9,20,80
16,1,0,0,0,112,266,154,57.9,42.1
16,1,0,1,-3,3,3,0,0,100
16,1,0,1,-2,4,5,1,20,80
16,1,0,1,-1,7,10,3,30,70
16,1,0,1,0,28,73,45,61.6,38.4
16,1,0,2,-4,1,1,0,0,100
16,1,0,2,-3,1,1,0,0,100
16,1,0,2,-1,1,2,1,50,50
16,1,0,2,0,5,16,11,68.8,31.2
16,1,0,12,-2,1,1,0,0,100
16,1,0,12,0,2,13,11,84.6,15.4
16,1,0,3,-1,1,1,0,0,100
16,1,0,3,0,0,4,4,100,0
16,1,0,13,-1,1,1,0,0,100
16,1,0,13,0,2,5,3,60,40
16,1,0,23,0,1,1,0,0,100
16,1,0,123,0,2,5,3,60,40
16,1,1,0,-5,5,5,0,0,100
16,1,1,0,-4,2,2,0,0,100
16,1,1,0,-3,7,7,0,0,100
16,1,1,0,-2,15,15,0,0,100
16,1,1,0,-1,29,34,5,14.7,85.3
16,1,1,0,0,80,178,98,55.1,44.9
16,1,1,1,-5,2,2,0,0,100
16,1,1,1,-3,7,7,0,0,100
16,1,1,1,-2,3,3,0,0,100
16,1,1,1,-1,11,15,4,26.7,73.3
16,1,1,1,0,23,62,39,62.9,37.1
16,1,1,2,-4,1,1,0,0,100
16,1,1,2,-3,1,1,0,0,100
16,1,1,2,-2,2,2,0,0,100
16,1,1,2,-1,2,5,3,60,40
16,1,1,2,0,11,36,25,69.4,30.6
16,1,1,12,-5,1,1,0,0,100
16,1,1,12,-3,1,1,0,0,100
16,1,1,12,-2,1,1,0,0,100
16,1,1,12,-1,2,4,2,50,50
16,1,1,12,0,8,31,23,74.2,25.8
16,1,1,3,-3,1,1,0,0,100
16,1,1,3,0,1,13,12,92.3,7.69999999999999
16,1,1,13,-1,1,1,0,0,100
16,1,1,13,0,1,14,13,92.9,7.09999999999999
16,1,1,23,-3,1,1,0,0,100
16,1,1,23,-2,1,1,0,0,100
16,1,1,23,0,3,7,4,57.1,42.9
16,1,1,123,-3,1,1,0,0,100
16,1,1,123,-1,1,1,0,0,100
16,1,1,123,0,6,15,9,60,40
16,1,2,0,-5,3,3,0,0,100
16,1,2,0,-4,2,2,0,0,100
16,1,2,0,-3,3,3,0,0,100
16,1,2,0,-2,14,14,0,0,100
16,1,2,0,-1,23,24,1,4.2,95.8
16,1,2,0,0,71,139,68,48.9,51.1
16,1,2,1,-3,4,4,0,0,100
16,1,2,1,-2,4,4,0,0,100
16,1,2,1,-1,10,11,1,9.1,90.9
16,1,2,1,0,30,70,40,57.1,42.9
16,1,2,2,-3,1,1,0,0,100
16,1,2,2,-2,3,3,0,0,100
16,1,2,2,-1,7,7,0,0,100
16,1,2,2,0,16,30,14,46.7,53.3
16,1,2,12,-5,1,1,0,0,100
16,1,2,12,-3,2,2,0,0,100
16,1,2,12,-2,5,5,0,0,100
16,1,2,12,-1,5,5,0,0,100
16,1,2,12,0,18,38,20,52.6,47.4
16,1,2,3,-3,1,1,0,0,100
16,1,2,3,-1,1,1,0,0,100
16,1,2,3,0,3,7,4,57.1,42.9
16,1,2,13,-1,1,2,1,50,50
16,1,2,13,0,6,17,11,64.7,35.3
16,1,2,23,-3,1,1,0,0,100
16,1,2,23,-1,1,1,0,0,100
16,1,2,23,0,3,6,3,50,50
16,1,2,123,-3,1,1,0,0,100
16,1,2,123,0,7,15,8,53.3,46.7
17,0,0,0,-1,4,4,0,0,100
17,0,0,0,0,106,194,88,45.4,54.6
17,0,0,1,-5,1,1,0,0,100
17,0,0,1,-1,1,1,0,0,100
17,0,0,1,0,27,46,19,41.3,58.7
17,0,0,2,-2,1,1,0,0,100
17,0,0,2,0,9,11,2,18.2,81.8
17,0,0,12,-3,1,1,0,0,100
17,0,0,12,-2,1,1,0,0,100
17,0,0,12,0,5,6,1,16.7,83.3
17,0,0,3,0,1,1,0,0,100
17,0,0,13,-1,2,2,0,0,100
17,0,0,13,0,2,2,0,0,100
17,0,0,23,0,1,1,0,0,100
17,0,0,123,-2,1,1,0,0,100
17,0,0,123,-1,1,1,0,0,100
17,0,1,0,-4,1,1,0,0,100
17,0,1,0,-3,3,3,0,0,100
17,0,1,0,-2,1,1,0,0,100
17,0,1,0,-1,3,3,0,0,100
17,0,1,0,0,66,133,67,50.4,49.6
17,0,1,1,-5,1,1,0,0,100
17,0,1,1,-3,1,1,0,0,100
17,0,1,1,-2,1,1,0,0,100
17,0,1,1,0,31,54,23,42.6,57.4
17,0,1,2,-3,1,1,0,0,100
17,0,1,2,-2,1,1,0,0,100
17,0,1,2,-1,1,1,0,0,100
17,0,1,2,0,23,34,11,32.4,67.6
17,0,1,12,-2,1,1,0,0,100
17,0,1,12,-1,3,3,0,0,100
17,0,1,12,0,14,18,4,22.2,77.8
17,0,1,3,-2,2,2,0,0,100
17,0,1,3,-1,1,1,0,0,100
17,0,1,3,0,4,6,2,33.3,66.7
17,0,1,13,-3,1,1,0,0,100
17,0,1,13,-2,1,1,0,0,100
17,0,1,13,-1,4,4,0,0,100
17,0,1,13,0,11,14,3,21.4,78.6
17,0,1,23,0,1,1,0,0,100
17,0,1,123,-1,3,3,0,0,100
17,0,1,123,0,3,4,1,25,75
17,0,2,0,-6,1,1,0,0,100
17,0,2,0,-4,1,1,0,0,100
17,0,2,0,-3,2,2,0,0,100
17,0,2,0,-2,2,2,0,0,100
17,0,2,0,-1,5,5,0,0,100
17,0,2,0,0,43,99,56,56.6,43.4
17,0,2,1,-5,2,2,0,0,100
17,0,2,1,-3,2,2,0,0,100
17,0,2,1,-2,3,3,0,0,100
17,0,2,1,-1,8,10,2,20,80
17,0,2,1,0,26,49,23,46.9,53.1
17,0,2,2,-6,1,1,0,0,100
17,0,2,2,-5,2,2,0,0,100
17,0,2,2,-4,3,3,0,0,100
17,0,2,2,-3,2,2,0,0,100
17,0,2,2,-2,3,3,0,0,100
17,0,2,2,-1,5,5,0,0,100
17,0,2,2,0,15,25,10,40,60
17,0,2,12,-3,1,1,0,0,100
17,0,2,12,-2,4,4,0,0,100
17,0,2,12,-1,10,11,1,9.1,90.9
17,0,2,12,0,16,26,10,38.5,61.5
17,0,2,3,-2,1,1,0,0,100
17,0,2,3,-1,2,3,1,33.3,66.7
17,0,2,3,0,4,10,6,60,40
17,0,2,13,-2,4,4,0,0,100
17,0,2,13,-1,1,2,1,50,50
17,0,2,13,0,6,9,3,33.3,66.7
17,0,2,23,-2,1,1,0,0,100
17,0,2,23,-1,0,1,1,100,0
17,0,2,23,0,3,5,2,40,60
17,0,2,123,-3,1,1,0,0,100
17,0,2,123,-2,1,1,0,0,100
17,0,2,123,-1,4,4,0,0,100
17,0,2,123,0,5,7,2,28.6,71.4
17,1,0,0,-6,1,1,0,0,100
17,1,0,0,-5,2,2,0,0,100
17,1,0,0,-4,2,2,0,0,100
17,1,0,0,-3,7,7,0,0,100
17,1,0,0,-2,12,12,0,0,100
17,1,0,0,-1,20,22,2,9.1,90.9
17,1,0,0,0,64,151,87,57.6,42.4
17,1,0,1,-6,1,1,0,0,100
17,1,0,1,-4,1,1,0,0,100
17,1,0,1,-3,3,3,0,0,100
17,1,0,1,-2,3,3,0,0,100
17,1,0,1,-1,4,5,1,20,80
17,1,0,1,0,11,37,26,70.3,29.7
17,1,0,2,0,4,6,2,33.3,66.7
17,1,0,12,-6,1,1,0,0,100
17,1,0,12,-3,2,2,0,0,100
17,1,0,12,-2,1,1,0,0,100
17,1,0,12,0,1,7,6,85.7,14.3
17,1,0,3,-5,1,1,0,0,100
17,1,0,3,0,1,2,1,50,50
17,1,0,13,-1,1,1,0,0,100
17,1,0,13,0,1,3,2,66.7,33.3
17,1,0,23,-3,1,1,0,0,100
17,1,0,23,0,0,1,1,100,0
17,1,0,123,-6,1,1,0,0,100
17,1,0,123,0,1,5,4,80,20
17,1,1,0,-5,1,1,0,0,100
17,1,1,0,-4,2,2,0,0,100
17,1,1,0,-3,5,5,0,0,100
17,1,1,0,-2,10,10,0,0,100
17,1,1,0,-1,15,15,0,0,100
17,1,1,0,0,48,105,57,54.3,45.7
17,1,1,1,-5,1,1,0,0,100
17,1,1,1,-4,1,1,0,0,100
17,1,1,1,-2,2,2,0,0,100
17,1,1,1,-1,2,2,0,0,100
17,1,1,1,0,12,38,26,68.4,31.6
17,1,1,2,-2,2,2,0,0,100
17,1,1,2,-1,2,3,1,33.3,66.7
17,1,1,2,0,8,26,18,69.2,30.8
17,1,1,12,-5,1,1,0,0,100
17,1,1,12,-3,1,1,0,0,100
17,1,1,12,-2,1,1,0,0,100
17,1,1,12,-1,1,2,1,50,50
17,1,1,12,0,4,19,15,78.9,21.1
17,1,1,3,0,3,4,1,25,75
17,1,1,13,-1,1,1,0,0,100
17,1,1,13,0,2,6,4,66.7,33.3
17,1,1,23,0,0,1,1,100,0
17,1,1,123,-6,1,1,0,0,100
17,1,1,123,-5,1,1,0,0,100
17,1,1,123,-2,1,1,0,0,100
17,1,1,123,-1,1,1,0,0,100
17,1,1,123,0,2,9,7,77.8,22.2
17,1,2,0,-4,1,1,0,0,100
17,1,2,0,-3,4,4,0,0,100
17,1,2,0,-2,9,9,0,0,100
17,1,2,0,-1,15,15,0,0,100
17,1,2,0,0,41,76,35,46.1,53.9
17,1,2,1,-4,1,1,0,0,100
17,1,2,1,-3,2,2,0,0,100
17,1,2,1,-2,3,3,0,0,100
17,1,2,1,-1,4,4,0,0,100
17,1,2,1,0,20,35,15,42.9,57.1
17,1,2,2,-2,2,2,0,0,100
17,1,2,2,-1,3,3,0,0,100
17,1,2,2,0,6,19,13,68.4,31.6
17,1,2,12,-1,3,3,0,0,100
17,1,2,12,0,5,15,10,66.7,33.3
17,1,2,3,0,3,4,1,25,75
17,1,2,13,-4,1,1,0,0,100
17,1,2,13,0,1,3,2,66.7,33.3
17,1,2,23,0,3,5,2,40,60
17,1,2,123,-6,1,1,0,0,100
17,1,2,123,-1,1,1,0,0,100
17,1,2,123,0,4,6,2,33.3,66.7
18,0,0,0,-1,1,1,0,0,100
18,0,0,0,0,59,109,50,45.9,54.1
18,0,0,1,0,17,30,13,43.3,56.7
18,0,0,2,0,5,9,4,44.4,55.6
18,0,0,12,-1,1,1,0,0,100
18,0,0,12,0,5,6,1,16.7,83.3
18,0,0,13,-1,1,1,0,0,100
18,0,0,13,0,3,3,0,0,100
18,0,0,23,0,1,1,0,0,100
18,0,0,123,-1,1,1,0,0,100
18,0,1,0,-2,1,1,0,0,100
18,0,1,0,-1,2,2,0,0,100
18,0,1,0,0,39,76,37,48.7,51.3
18,0,1,1,-1,3,3,0,0,100
18,0,1,1,0,12,30,18,60,40
18,0,1,2,-3,1,1,0,0,100
18,0,1,2,-1,2,3,1,33.3,66.7
18,0,1,2,0,9,15,6,40,60
18,0,1,12,-3,1,1,0,0,100
18,0,1,12,-2,1,2,1,50,50
18,0,1,12,-1,4,4,0,0,100
18,0,1,12,0,4,10,6,60,40
18,0,1,3,-1,2,2,0,0,100
18,0,1,3,0,1,4,3,75,25
18,0,1,13,-1,3,3,0,0,100
18,0,1,13,0,5,7,2,28.6,71.4
18,0,1,23,-2,1,1,0,0,100
18,0,1,23,-1,2,2,0,0,100
18,0,1,23,0,2,2,0,0,100
18,0,1,123,-3,1,1,0,0,100
18,0,1,123,-2,1,1,0,0,100
18,0,1,123,-1,2,2,0,0,100
18,0,1,123,0,3,4,1,25,75
18,0,2,0,-3,1,1,0,0,100
18,0,2,0,-2,1,1,0,0,100
18,0,2,0,-1,2,2,0,0,100
18,0,2,0,0,27,54,27,50,50
18,0,2,1,-2,1,1,0,0,100
18,0,2,1,-1,3,3,0,0,100
18,0,2,1,0,14,30,16,53.3,46.7
18,0,2,2,-3,1,1,0,0,100
18,0,2,2,-2,1,1,0,0,100
18,0,2,2,-1,2,3,1,33.3,66.7
18,0,2,2,0,9,13,4,30.8,69.2
18,0,2,12,-5,1,1,0,0,100
18,0,2,12,-4,1,1,0,0,100
18,0,2,12,-3,1,1,0,0,100
18,0,2,12,-2,3,3,0,0,100
18,0,2,12,-1,5,5,0,0,100
18,0,2,12,0,8,14,6,42.9,57.1
18,0,2,3,0,3,5,2,40,60
18,0,2,13,-4,1,1,0,0,100
18,0,2,13,-2,3,3,0,0,100
18,0,2,13,-1,2,2,0,0,100
18,0,2,13,0,3,4,1,25,75
18,0,2,23,-1,1,1,0,0,100
18,0,2,23,0,2,4,2,50,50
18,0,2,123,-5,1,1,0,0,100
18,0,2,123,-2,2,2,0,0,100
18,0,2,123,-1,1,1,0,0,100
18,0,2,123,0,2,2,0,0,100
18,1,0,0,-5,1,1,0,0,100
18,1,0,0,-4,1,1,0,0,100
18,1,0,0,-3,2,2,0,0,100
18,1,0,0,-2,6,7,1,14.3,85.7
18,1,0,0,-1,14,15,1,6.7,93.3
18,1,0,0,0,36,84,48,57.1,42.9
18,1,0,1,-3,1,1,0,0,100
18,1,0,1,-1,3,4,1,25,75
18,1,0,1,0,6,16,10,62.5,37.5
18,1,0,2,-3,1,1,0,0,100
18,1,0,2,-2,0,1,1,100,0
18,1,0,2,-1,1,1,0,0,100
18,1,0,2,0,3,6,3,50,50
18,1,0,12,-1,1,1,0,0,100
18,1,0,12,0,2,4,2,50,50
18,1,0,13,-2,0,1,1,100,0
18,1,0,13,-1,1,1,0,0,100
18,1,0,13,0,1,4,3,75,25
18,1,0,23,0,0,1,1,100,0
18,1,0,123,0,1,1,0,0,100
18,1,1,0,-5,1,1,0,0,100
18,1,1,0,-4,1,1,0,0,100
18,1,1,0,-3,1,1,0,0,100
18,1,1,0,-2,6,6,0,0,100
18,1,1,0,-1,10,10,0,0,100
18,1,1,0,0,28,63,35,55.6,44.4
18,1,1,1,-2,1,1,0,0,100
18,1,1,1,-1,3,4,1,25,75
18,1,1,1,0,9,23,14,60.9,39.1
18,1,1,2,0,1,6,5,83.3,16.7
18,1,1,12,-1,1,1,0,0,100
18,1,1,12,0,3,6,3,50,50
18,1,1,3,0,1,4,3,75,25
18,1,1,13,-1,1,1,0,0,100
18,1,1,13,0,1,6,5,83.3,16.7
18,1,1,23,0,1,4,3,75,25
18,1,1,123,-1,1,1,0,0,100
18,1,1,123,0,3,8,5,62.5,37.5
18,1,2,0,-5,1,1,0,0,100
18,1,2,0,-4,1,1,0,0,100
18,1,2,0,-3,1,1,0,0,100
18,1,2,0,-2,5,5,0,0,100
18,1,2,0,-1,9,9,0,0,100
18,1,2,0,0,23,46,23,50,50
18,1,2,1,-2,2,2,0,0,100
18,1,2,1,-1,5,5,0,0,100
18,1,2,1,0,5,16,11,68.8,31.2
18,1,2,2,-5,1,1,0,0,100
18,1,2,2,0,5,11,6,54.5,45.5
18,1,2,12,-1,1,1,0,0,100
18,1,2,12,0,3,6,3,50,50
18,1,2,3,0,0,5,5,100,0
18,1,2,13,0,1,3,2,66.7,33.3
18,1,2,23,0,0,2,2,100,0
18,1,2,123,-1,1,1,0,0,100
18,1,2,123,0,2,4,2,50,50
19,0,0,0,-1,1,1,0,0,100
19,0,0,0,0,33,59,26,44.1,55.9
19,0,0,1,-2,1,1,0,0,100
19,0,0,1,0,13,21,8,38.1,61.9
19,0,0,2,0,0,3,3,100,0
19,0,0,12,0,2,2,0,0,100
19,0,0,3,-1,1,1,0,0,100
19,0,0,123,-1,1,1,0,0,100
19,0,0,123,0,1,1,0,0,100
19,0,1,0,-2,1,1,0,0,100
19,0,1,0,-1,2,2,0,0,100
19,0,1,0,0,19,35,16,45.7,54.3
19,0,1,1,-1,1,1,0,0,100
19,0,1,1,0,5,11,6,54.5,45.5
19,0,1,2,-4,1,1,0,0,100
19,0,1,2,-2,1,1,0,0,100
19,0,1,2,0,10,15,5,33.3,66.7
19,0,1,12,-2,1,1,0,0,100
19,0,1,12,-1,0,1,1,100,0
19,0,1,12,0,7,9,2,22.2,77.8
19,0,1,3,0,1,1,0,0,100
19,0,1,23,-1,1,1,0,0,100
19,0,1,23,0,0,2,2,100,0
19,0,1,123,-2,0,1,1,100,0
19,0,1,123,-1,2,3,1,33.3,66.7
19,0,1,123,0,1,2,1,50,50
19,0,2,0,-2,1,1,0,0,100
19,0,2,0,-1,1,1,0,0,100
19,0,2,0,0,13,28,15,53.6,46.4
19,0,2,1,-5,1,1,0,0,100
19,0,2,1,-1,1,2,1,50,50
19,0,2,1,0,6,17,11,64.7,35.3
19,0,2,2,-4,2,2,0,0,100
19,0,2,2,-2,1,1,0,0,100
19,0,2,2,0,4,8,4,50,50
19,0,2,12,-2,1,1,0,0,100
19,0,2,12,-1,3,3,0,0,100
19,0,2,12,0,4,7,3,42.9,57.1
19,0,2,3,-4,1,1,0,0,100
19,0,2,3,0,3,3,0,0,100
19,0,2,13,-3,2,2,0,0,100
19,0,2,13,-1,1,1,0,0,100
19,0,2,13,0,3,4,1,25,75
19,0,2,23,-2,1,1,0,0,100
19,0,2,23,-1,1,1,0,0,100
19,0,2,23,0,1,2,1,50,50
19,0,2,123,-2,0,1,1,100,0
19,0,2,123,-1,4,4,0,0,100
19,0,2,123,0,1,2,1,50,50
19,1,0,0,-5,1,1,0,0,100
19,1,0,0,-4,2,2,0,0,100
19,1,0,0,-3,2,2,0,0,100
19,1,0,0,-2,2,3,1,33.3,66.7
19,1,0,0,-1,5,6,1,16.7,83.3
19,1,0,0,0,21,45,24,53.3,46.7
19,1,0,1,-2,0,1,1,100,0
19,1,0,1,-1,5,5,0,0,100
19,1,0,1,0,1,7,6,85.7,14.3
19,1,0,2,-2,0,1,1,100,0
19,1,0,2,0,0,1,1,100,0
19,1,0,12,0,0,4,4,100,0
19,1,0,13,-2,0,1,1,100,0
19,1,0,123,-2,0,1,1,100,0
19,1,0,123,0,0,2,2,100,0
19,1,1,0,-5,1,1,0,0,100
19,1,1,0,-4,2,2,0,0,100
19,1,1,0,-3,2,2,0,0,100
19,1,1,0,-2,2,2,0,0,100
19,1,1,0,-1,1,2,1,50,50
19,1,1,0,0,20,35,15,42.9,57.1
19,1,1,1,-1,1,2,1,50,50
19,1,1,1,0,4,13,9,69.2,30.8
19,1,1,2,-5,1,1,0,0,100
19,1,1,2,-2,1,1,0,0,100
19,1,1,2,-1,4,4,0,0,100
19,1,1,2,0,2,6,4,66.7,33.3
19,1,1,12,0,3,7,4,57.1,42.9
19,1,1,13,0,0,1,1,100,0
19,1,1,23,0,0,2,2,100,0
19,1,1,123,0,0,2,2,100,0
19,1,2,0,-4,2,2,0,0,100
19,1,2,0,-3,2,2,0,0,100
19,1,2,0,-2,1,1,0,0,100
19,1,2,0,0,16,23,7,30.4,69.6
19,1,2,1,-4,2,2,0,0,100
19,1,2,1,-1,1,1,0,0,100
19,1,2,1,0,9,12,3,25,75
19,1,2,2,-5,1,1,0,0,100
19,1,2,2,-2,1,1,0,0,100
19,1,2,2,-1,1,2,1,50,50
19,1,2,2,0,4,8,4,50,50
19,1,2,12,-5,1,1,0,0,100
19,1,2,12,0,7,10,3,30,70
19,1,2,3,-1,2,2,0,0,100
19,1,2,3,0,1,1,0,0,100
19,1,2,13,-3,1,1,0,0,100
19,1,2,13,0,0,3,3,100,0
19,1,2,23,0,0,1,1,100,0
19,1,2,123,-5,1,1,0,0,100
19,1,2,123,0,0,2,2,100,0
20,0,0,0,-1,1,1,0,0,100
20,0,0,0,0,20,32,12,37.5,62.5
20,0,0,1,0,7,8,1,12.5,87.5
20,0,0,2,-1,1,1,0,0,100
20,0,0,12,-2,1,1,0,0,100
20,0,0,12,0,4,4,0,0,100
20,0,0,13,-1,1,1,0,0,100
20,0,0,13,0,1,1,0,0,100
20,0,0,123,-2,1,1,0,0,100
20,0,0,123,-1,1,1,0,0,100
20,0,0,123,0,1,1,0,0,100
20,0,1,0,-2,1,1,0,0,100
20,0,1,0,0,13,25,12,48,52
20,0,1,1,-2,1,1,0,0,100
20,0,1,1,-1,1,1,0,0,100
20,0,1,1,0,7,10,3,30,70
20,0,1,2,-2,1,1,0,0,100
20,0,1,12,0,2,2,0,0,100
20,0,1,3,-1,1,1,0,0,100
20,0,1,13,0,0,2,2,100,0
20,0,1,23,-2,1,1,0,0,100
20,0,1,23,-1,0,1,1,100,0
20,0,1,123,-3,1,1,0,0,100
20,0,1,123,-2,2,2,0,0,100
20,0,2,0,-2,1,1,0,0,100
20,0,2,0,0,9,18,9,50,50
20,0,2,1,-3,1,1,0,0,100
20,0,2,1,-2,1,1,0,0,100
20,0,2,1,-1,2,2,0,0,100
20,0,2,1,0,6,7,1,14.3,85.7
20,0,2,2,-2,1,1,0,0,100
20,0,2,2,-1,0,1,1,100,0
20,0,2,2,0,1,2,1,50,50
20,0,2,12,-4,1,1,0,0,100
20,0,2,3,-2,1,1,0,0,100
20,0,2,3,-1,1,1,0,0,100
20,0,2,13,-1,2,2,0,0,100
20,0,2,13,0,3,4,1,25,75
20,0,2,23,0,0,1,1,100,0
20,0,2,123,-2,1,1,0,0,100
20,0,2,123,0,0,1,1,100,0
20,1,0,0,-4,1,1,0,0,100
20,1,0,0,-3,2,2,0,0,100
20,1,0,0,-2,2,2,0,0,100
20,1,0,0,-1,4,5,1,20,80
20,1,0,0,0,11,22,11,50,50
20,1,0,1,-4,1,1,0,0,100
20,1,0,1,-2,1,1,0,0,100
20,1,0,1,-1,0,1,1,100,0
20,1,0,1,0,1,5,4,80,20
20,1,0,12,-4,1,1,0,0,100
20,1,0,12,-1,0,1,1,100,0
20,1,0,3,0,0,1,1,100,0
20,1,0,13,0,0,1,1,100,0
20,1,0,123,-1,0,1,1,100,0
20,1,0,123,0,0,1,1,100,0
20,1,1,0,-3,2,2,0,0,100
20,1,1,0,-2,1,1,0,0,100
20,1,1,0,-1,4,4,0,0,100
20,1,1,0,0,10,16,6,37.5,62.5
20,1,1,1,-2,1,1,0,0,100
20,1,1,1,0,4,8,4,50,50
20,1,1,2,0,0,3,3,100,0
20,1,1,12,-4,1,1,0,0,100
20,1,1,12,0,0,5,5,100,0
20,1,1,13,0,0,1,1,100,0
20,1,1,123,-1,0,1,1,100,0
20,1,1,123,0,0,1,1,100,0
20,1,2,0,-3,2,2,0,0,100
20,1,2,0,-2,2,2,0,0,100
20,1,2,0,-1,4,4,0,0,100
20,1,2,0,0,7,10,3,30,70
20,1,2,1,-3,1,1,0,0,100
20,1,2,1,-2,2,2,0,0,100
20,1,2,1,-1,2,2,0,0,100
20,1,2,1,0,5,6,1,16.7,83.3
20,1,2,12,-3,1,1,0,0,100
20,1,2,12,-2,1,1,0,0,100
20,1,2,12,-1,2,2,0,0,100
20,1,2,12,0,1,3,2,66.7,33.3
20,1,2,13,-4,1,1,0,0,100
20,1,2,13,0,1,1,0,0,100
20,1,2,123,-1,1,1,0,0,100
21,0,0,0,0,11,17,6,35.3,64.7
21,0,0,1,0,3,4,1,25,75
21,0,0,12,0,0,1,1,100,0
21,0,0,23,0,0,1,1,100,0
21,0,1,0,-3,1,1,0,0,100
21,0,1,0,0,8,13,5,38.5,61.5
21,0,1,1,0,3,3,0,0,100
21,0,1,2,0,3,3,0,0,100
21,0,1,12,0,1,1,0,0,100
21,0,1,3,0,1,1,0,0,100
21,0,1,13,0,1,1,0,0,100
21,0,1,23,0,1,2,1,50,50
21,0,1,123,-1,1,1,0,0,100
21,0,1,123,0,1,1,0,0,100
21,0,2,0,-3,1,2,1,50,50
21,0,2,0,0,5,10,5,50,50
21,0,2,1,-3,1,1,0,0,100
21,0,2,1,0,3,5,2,40,60
21,0,2,2,-1,1,1,0,0,100
21,0,2,2,0,1,1,0,0,100
21,0,2,12,-1,1,1,0,0,100
21,0,2,12,0,2,5,3,60,40
21,0,2,13,-1,0,1,1,100,0
21,0,2,23,-2,1,1,0,0,100
21,0,2,23,0,1,1,0,0,100
21,0,2,123,-1,2,2,0,0,100
21,0,2,123,0,1,1,0,0,100
21,1,0,0,-3,1,2,1,50,50
21,1,0,0,-2,1,1,0,0,100
21,1,0,0,-1,2,3,1,33.3,66.7
21,1,0,0,0,7,11,4,36.4,63.6
21,1,0,1,-2,0,1,1,100,0
21,1,0,1,0,2,2,0,0,100
21,1,0,2,-3,0,1,1,100,0
21,1,0,2,-1,0,1,1,100,0
21,1,0,12,-2,0,1,1,100,0
21,1,1,0,-3,1,1,0,0,100
21,1,1,0,-2,1,1,0,0,100
21,1,1,0,-1,2,2,0,0,100
21,1,1,0,0,5,9,4,44.4,55.6
21,1,1,1,0,1,2,1,50,50
21,1,1,2,0,3,3,0,0,100
21,1,1,12,-2,0,1,1,100,0
21,1,1,12,0,1,3,2,66.7,33.3
21,1,1,3,-1,0,1,1,100,0
21,1,1,123,-2,0,1,1,100,0
21,1,2,0,-3,1,1,0,0,100
21,1,2,0,-2,1,1,0,0,100
21,1,2,0,-1,2,2,0,0,100
21,1,2,0,0,3,7,4,57.1,42.9
21,1,2,1,-3,1,1,0,0,100
21,1,2,1,0,2,5,3,60,40
21,1,2,2,0,2,3,1,33.3,66.7
21,1,2,12,-3,1,1,0,0,100
21,1,2,12,0,1,2,1,50,50
21,1,2,13,0,0,1,1,100,0
22,0,0,0,-1,1,1,0,0,100
22,0,0,0,0,7,12,5,41.7,58.3
22,0,0,1,0,2,2,0,0,100
22,0,1,0,-2,1,1,0,0,100
22,0,1,0,-1,1,1,0,0,100
22,0,1,0,0,4,9,5,55.6,44.4
22,0,1,1,0,2,3,1,33.3,66.7
22,0,1,2,0,2,2,0,0,100
22,0,1,12,0,1,1,0,0,100
22,0,2,0,-2,1,1,0,0,100
22,0,2,0,-1,1,1,0,0,100
22,0,2,0,0,2,6,4,66.7,33.3
22,0,2,1,0,2,3,1,33.3,66.7
22,0,2,2,-1,1,1,0,0,100
22,0,2,2,0,1,2,1,50,50
22,0,2,12,0,3,3,0,0,100
22,0,2,3,0,1,1,0,0,100
22,0,2,13,-1,1,1,0,0,100
22,0,2,123,0,1,1,0,0,100
22,1,0,0,-2,1,1,0,0,100
22,1,0,0,-1,3,3,0,0,100
22,1,0,0,0,3,8,5,62.5,37.5
22,1,0,1,-1,2,2,0,0,100
22,1,0,1,0,2,3,1,33.3,66.7
22,1,0,12,-1,1,1,0,0,100
22,1,1,0,-2,1,1,0,0,100
22,1,1,0,-1,1,1,0,0,100
22,1,1,0,0,1,4,3,75,25
22,1,1,1,0,1,4,3,75,25
22,1,1,2,0,1,3,2,66.7,33.3
22,1,1,12,0,1,2,1,50,50
22,1,1,13,0,0,1,1,100,0
22,1,1,23,-1,1,1,0,0,100
22,1,1,123,0,0,1,1,100,0
22,1,2,0,-2,1,1,0,0,100
22,1,2,0,-1,2,2,0,0,100
22,1,2,0,0,1,1,0,0,100
22,1,2,1,-2,1,1,0,0,100
22,1,2,1,-1,2,2,0,0,100
22,1,2,1,0,1,2,1,50,50
22,1,2,12,0,2,3,1,33.3,66.7
22,1,2,3,0,0,1,1,100,0
22,1,2,13,0,0,1,1,100,0
22,1,2,23,-1,1,1,0,0,100
22,1,2,123,-1,1,1,0,0,100
23,0,0,0,0,3,5,2,40,60
23,0,1,0,0,3,5,2,40,60
23,0,2,0,0,3,5,2,40,60
23,0,2,1,0,2,3,1,33.3,66.7
23,0,2,12,0,0,1,1,100,0
23,0,2,3,0,1,1,0,0,100
23,0,2,13,-2,1,1,0,0,100
23,0,2,13,0,1,1,0,0,100
23,0,2,23,-1,1,1,0,0,100
23,1,0,0,-2,1,1,0,0,100
23,1,0,0,0,2,4,2,50,50
23,1,0,1,0,0,1,1,100,0
23,1,1,0,-2,1,1,0,0,100
23,1,1,0,0,2,3,1,33.3,66.7
23,1,1,1,0,1,2,1,50,50
23,1,1,12,0,1,1,0,0,100
23,1,2,0,-2,1,1,0,0,100
23,1,2,0,0,1,2,1,50,50
23,1,2,1,0,0,1,1,100,0
23,1,2,12,0,1,2,1,50,50
23,1,2,123,0,1,1,0,0,100
24,0,0,0,0,2,4,2,50,50
24,0,0,1,0,2,2,0,0,100
24,0,1,0,0,0,2,2,100,0
24,0,1,1,0,2,3,1,33.3,66.7
24,0,1,12,0,1,1,0,0,100
24,0,1,123,0,1,1,0,0,100
24,0,2,0,0,0,1,1,100,0
24,0,2,1,0,0,1,1,100,0
24,0,2,2,0,1,1,0,0,100
24,0,2,12,0,1,1,0,0,100
24,0,2,123,0,1,1,0,0,100
24,1,0,0,0,2,4,2,50,50
24,1,0,1,0,0,1,1,100,0
24,1,0,2,0,0,1,1,100,0
24,1,0,12,0,0,1,1,100,0
24,1,1,0,0,2,3,1,33.3,66.7
24,1,1,23,0,0,1,1,100,0
24,1,1,123,0,0,1,1,100,0
24,1,2,0,0,2,3,1,33.3,66.7
24,1,2,1,0,1,1,0,0,100
24,1,2,2,0,1,2,1,50,50
24,1,2,12,0,1,1,0,0,100
24,1,2,123,0,1,1,0,0,100
25,0,0,0,-1,1,1,0,0,100
25,0,0,0,0,1,2,1,50,50
25,0,0,1,0,1,2,1,50,50
25,0,1,0,-1,1,1,0,0,100
25,0,2,0,-1,1,1,0,0,100
25,0,2,0,0,0,1,1,100,0
25,1,0,0,-1,1,1,0,0,100
25,1,0,0,0,0,1,1,100,0
25,1,1,0,-1,1,1,0,0,100
25,1,1,0,0,0,1,1,100,0
25,1,2,0,-1,1,1,0,0,100
25,1,2,1,-1,1,1,0,0,100
